1
54-1
False,0
False,0
45,45
0,0,0,5,5,0,3,3,3,3,3,3,3,5,0,0,0,3,3,7,5,0,0,16,16,5,6,7,8,16,16,16,6,5,3,3,0,0,5,5,6,8,5,5,16
5,7,0,0,0,0,0,0,0,0,3,3,0,0,0,0,3,3,7,5,0,0,0,16,5,7,7,8,16,16,16,16,16,3,3,0,0,0,6,6,8,5,5,5,6
0,5,5,0,0,0,0,0,0,0,0,0,0,0,0,3,6,6,5,0,0,0,0,5,7,3,8,8,16,3,3,3,3,3,16,16,16,6,6,8,5,5,5,5,16
0,0,0,8,7,0,0,0,0,0,0,0,0,0,6,5,6,0,0,0,0,0,3,3,3,8,8,3,3,3,3,3,3,16,16,16,6,8,5,5,6,6,16,16,9
16,16,3,0,0,8,7,7,7,6,6,6,6,8,7,5,0,0,0,0,3,3,3,3,8,3,3,3,3,3,3,3,16,16,16,5,8,8,6,6,16,16,9,9,9
11,11,16,16,0,0,8,8,8,8,8,8,8,5,0,0,0,0,0,3,3,3,3,5,3,3,3,3,3,0,0,0,6,5,5,6,6,6,16,16,9,9,9,9,9
11,11,11,11,16,0,0,0,0,0,0,0,0,0,0,0,0,0,3,3,3,3,3,3,3,3,0,0,0,0,6,5,5,6,6,6,6,16,4,4,4,4,4,4,4
11,11,11,11,11,16,0,0,0,0,0,0,0,0,0,0,0,0,0,0,0,0,0,0,0,0,0,7,7,5,5,6,6,6,6,16,16,4,4,4,4,4,4,4,4
4,4,9,1,1,1,16,16,0,0,3,3,8,8,8,8,8,8,8,8,7,7,7,7,7,6,6,6,6,6,6,6,6,16,16,4,4,4,4,4,4,4,4,4,4
9,4,1,1,1,1,1,1,16,0,0,0,0,6,6,6,6,6,6,6,6,6,6,6,6,6,6,6,6,16,16,16,16,4,4,4,4,4,4,4,4,4,4,4,4
9,1,1,1,1,1,1,1,9,16,16,16,16,16,0,6,6,6,16,16,16,16,16,16,16,16,16,16,16,16,4,4,4,4,4,4,4,4,4,4,4,4,4,4,4
9,1,1,1,1,1,1,1,9,9,9,9,9,16,16,16,16,4,4,4,4,4,4,4,4,4,4,4,4,4,4,4,4,4,4,4,4,4,4,4,4,4,4,4,4
9,1,1,1,1,1,1,1,9,9,9,9,4,4,4,4,4,4,4,4,4,4,4,4,4,4,4,4,4,4,4,4,4,4,4,4,4,4,4,4,4,4,4,4,4
9,1,1,1,1,1,1,1,9,9,9,9,4,4,4,4,4,4,4,4,4,4,4,4,4,4,4,4,4,4,4,4,4,2,2,2,2,2,2,4,4,4,4,4,4
9,4,1,1,1,1,1,1,9,9,9,2,4,4,4,4,4,4,4,4,4,4,4,4,4,4,4,4,4,4,2,2,2,2,2,2,2,2,2,2,2,4,4,4,4
9,9,1,1,1,1,1,1,4,4,4,4,4,4,4,4,4,4,4,4,4,4,4,4,4,4,4,4,4,2,2,2,2,2,2,2,2,2,2,2,2,2,2,4,4
4,0,4,4,1,1,1,1,4,4,4,4,4,4,4,4,4,4,4,4,4,4,4,4,4,4,4,4,2,2,2,2,2,2,2,2,2,2,2,2,2,2,2,2,4
4,0,4,4,4,4,4,4,4,4,4,4,4,4,4,4,4,4,4,4,4,4,4,4,4,4,4,2,2,2,2,2,2,2,2,2,2,2,2,2,2,2,2,2,4
4,4,4,4,4,4,4,4,4,4,4,4,4,4,4,4,4,4,4,4,4,4,4,4,4,4,4,2,2,2,2,2,2,2,2,2,2,2,2,2,2,2,2,2,2
4,4,4,4,4,4,4,4,4,4,4,4,4,4,4,4,4,4,4,4,4,4,4,4,4,4,2,2,2,2,2,2,2,2,2,2,2,2,2,2,2,2,2,2,2
4,4,4,4,4,4,4,4,9,9,4,4,4,4,4,4,4,4,4,4,4,4,4,4,4,4,4,2,4,4,4,4,2,2,2,2,2,2,2,2,2,2,2,2,4
4,4,4,4,4,4,9,9,9,9,4,4,4,4,4,4,4,4,4,4,4,4,4,4,4,4,4,4,4,4,4,4,2,2,2,2,2,2,2,2,2,2,2,2,4
4,4,4,4,4,4,4,9,9,9,4,4,4,4,4,4,4,4,4,4,4,4,4,4,4,4,4,4,4,4,4,4,2,2,2,4,4,4,2,2,2,2,2,2,4
4,4,4,9,9,9,9,9,9,9,4,4,4,1,1,1,4,4,4,4,4,4,4,4,4,4,4,4,4,4,4,4,2,2,2,4,4,4,2,2,2,2,2,2,4
4,4,4,9,9,9,9,9,9,4,4,4,4,1,1,1,4,4,4,4,4,4,4,4,4,4,4,4,4,4,2,2,2,2,2,4,4,4,2,2,2,2,2,2,2
4,4,4,9,9,9,9,9,4,4,4,4,4,4,1,1,1,4,4,4,4,4,4,4,4,4,4,4,4,4,2,2,2,2,2,2,2,2,2,2,2,2,2,2,2
4,4,4,4,4,9,9,4,4,4,4,4,4,4,4,4,4,4,4,4,4,4,4,4,4,4,4,4,4,4,2,2,2,2,2,2,2,2,2,2,2,2,2,2,0
2,4,4,4,4,9,9,4,4,4,4,4,4,4,4,4,4,4,4,4,4,4,4,4,4,4,4,4,4,4,2,2,2,2,2,2,2,2,2,2,2,2,1,0,0
2,2,4,4,4,9,9,4,4,4,4,4,4,4,4,4,4,4,4,4,4,4,4,4,4,4,4,2,2,2,2,2,2,2,2,2,2,1,1,1,2,2,1,1,0
2,2,4,4,4,4,4,4,4,4,4,4,4,4,4,4,4,4,4,4,4,4,4,4,4,4,4,4,2,2,2,2,2,2,2,2,2,1,1,1,2,2,1,0,0
2,2,2,4,4,4,4,4,4,4,4,4,4,4,4,4,4,4,4,4,4,4,4,4,4,4,4,4,2,2,2,2,2,2,2,2,2,1,1,1,2,1,0,0,0
0,2,2,2,4,4,4,4,4,9,9,4,4,4,4,4,4,4,4,4,4,4,4,4,4,4,4,4,2,2,2,2,2,2,2,2,2,2,1,1,1,1,0,0,0
13,0,2,2,2,2,4,4,4,4,4,4,4,4,4,4,4,4,4,4,4,4,4,2,4,4,4,4,2,2,2,2,2,2,2,2,1,1,1,1,1,1,1,0,0
13,13,0,2,2,2,4,4,4,4,4,4,4,4,4,4,4,4,4,4,4,4,4,2,2,1,1,2,2,2,2,2,2,1,1,1,1,1,1,1,1,1,0,0,0
13,13,13,0,2,2,2,4,4,4,4,4,4,4,1,1,1,4,4,4,4,4,2,2,2,1,1,1,1,1,1,1,1,1,1,1,1,1,1,1,0,0,0,0,0
13,13,13,13,0,0,0,2,2,4,4,4,4,1,1,1,1,1,1,1,1,2,2,2,2,1,1,1,1,1,1,1,1,1,1,1,1,1,1,1,1,15,15,15,15
13,13,13,13,13,0,0,0,1,2,2,4,4,1,1,1,1,1,1,1,1,1,1,1,1,1,1,1,1,1,1,1,1,1,1,1,1,1,1,1,1,1,1,1,1
13,13,13,13,13,13,13,0,0,0,0,1,4,1,1,1,1,1,1,1,1,1,1,1,1,1,1,1,1,1,1,1,1,1,1,1,1,1,1,1,1,1,1,1,0
13,13,13,13,13,13,13,13,14,14,0,0,1,1,1,1,1,1,1,1,1,1,1,1,1,1,1,1,1,1,1,1,1,1,1,1,1,1,1,1,1,1,1,0,0
13,13,13,13,13,13,13,13,13,13,14,0,0,0,1,1,1,1,1,1,1,1,1,1,1,1,1,1,1,1,1,1,1,1,1,1,1,1,0,0,0,0,0,0,15
13,13,13,13,13,13,13,13,13,13,13,14,14,0,0,0,0,0,0,0,0,0,0,1,1,1,1,1,1,1,1,1,1,0,0,0,0,0,0,15,15,15,15,15,15
13,13,13,13,13,13,13,13,13,13,13,13,13,14,14,14,15,15,15,0,0,0,0,0,0,0,0,0,0,0,0,0,0,15,15,15,15,15,15,15,15,15,15,15,15
13,13,13,13,13,13,13,13,13,13,13,13,13,13,13,15,15,14,15,15,15,15,15,15,15,15,15,15,15,15,15,15,15,15,15,15,15,15,15,15,15,15,15,14,10
13,13,13,13,13,13,13,13,13,13,13,13,13,13,13,13,13,13,13,14,14,14,15,15,15,15,15,15,15,15,15,15,15,15,15,15,15,15,15,14,14,10,10,10,10
13,13,13,13,13,13,13,13,13,13,13,13,13,13,13,13,13,13,13,13,13,13,13,14,14,14,14,14,14,14,14,14,14,14,14,14,14,10,10,12,10,10,13,11,11
1,0.8313726,0.3960785
0.9490197,0.7843138,0.2941177
0.9882354,0.7607844,0.09803922
0.9803922,0.7372549,0.3568628
0.9019608,0.6745098,0
0.9529412,0.6039216,0
0.9803922,0.6235294,0.3568628
0.909804,0.5137255,0.2196079
0.7764707,0.372549,0.07450981
0.7215686,0.5450981,0
0.4352942,0.3686275,0.2901961
0.1568628,0.1960784,0.1882353
0.08235294,0.1019608,0.03137255
0.1176471,0.1098039,0.007843138
0.8313726,0.8745099,0.6666667
0.9803922,1,0.8313726
1,0.9686275,0.6392157