1
54-6
False,0
False,0
45,45
0,0,0,0,0,0,0,0,0,5,5,0,2,2,2,2,0,0,0,2,2,15,15,19,19,19,19,19,18,2,4,4,4,4,4,4,2,5,5,5,6,6,6,7,7
0,0,0,0,0,0,0,0,0,0,5,5,5,2,0,0,0,2,2,5,15,15,15,15,19,19,19,18,2,2,4,4,4,4,4,2,5,5,5,5,5,6,6,6,6
0,0,0,0,0,0,0,0,0,0,0,2,0,0,2,2,16,16,3,5,3,15,17,15,15,15,19,18,2,4,4,4,4,4,2,5,5,6,6,5,5,6,6,6,6
0,0,0,0,0,0,0,0,0,0,2,0,0,3,16,16,10,10,16,15,3,15,17,17,17,15,18,2,2,4,4,4,4,2,5,6,6,6,6,6,5,5,5,5,5
0,0,0,0,0,0,0,0,0,0,2,2,16,16,10,10,10,10,16,15,3,15,8,8,8,15,18,2,4,4,4,4,4,2,5,6,6,6,6,6,5,5,5,5,5
0,0,0,0,0,0,0,0,0,0,2,2,10,10,10,10,10,16,15,3,3,15,15,15,15,18,2,2,2,4,4,4,2,6,6,9,9,9,6,6,5,5,5,5,5
0,0,0,0,0,0,0,0,0,2,2,16,10,10,16,16,16,16,15,3,3,15,19,19,18,18,2,0,2,4,4,2,5,6,9,9,9,9,6,6,6,5,5,5,5
0,0,0,0,0,0,0,0,0,2,2,16,10,16,11,11,11,11,16,15,15,19,19,19,18,2,0,0,2,4,2,5,5,6,9,9,9,9,6,6,6,5,5,5,5
0,0,0,0,0,0,0,0,0,0,16,10,16,11,11,11,11,11,11,16,11,19,19,18,18,16,16,0,2,3,5,2,2,5,5,9,9,9,6,6,6,6,5,5,5
0,0,0,0,0,0,0,0,0,0,16,11,11,11,11,12,12,12,12,12,16,11,19,18,16,11,16,0,2,2,0,0,0,5,5,5,5,9,6,6,6,6,5,5,5
0,0,0,0,0,0,0,0,0,16,11,11,11,11,10,10,11,12,12,12,12,16,18,18,16,11,16,0,2,0,0,0,0,0,0,5,5,5,5,5,6,6,5,5,5
0,0,0,0,0,0,0,0,0,16,11,11,12,12,12,10,10,11,12,12,12,12,16,16,11,11,16,2,0,0,0,0,0,0,0,0,0,5,5,5,5,5,5,5,5
0,0,0,0,0,0,0,0,16,11,11,12,12,12,12,12,16,10,10,12,12,12,12,16,11,11,16,2,0,0,0,0,0,0,0,0,0,0,0,5,5,5,5,5,5
0,0,0,0,0,0,0,16,11,10,11,12,12,12,12,12,12,16,16,10,12,12,12,11,16,16,16,0,0,0,0,0,0,0,0,0,0,0,0,0,0,5,5,5,9
0,0,0,0,0,0,16,11,11,10,10,10,12,12,12,12,12,12,12,16,10,12,11,11,14,16,0,0,0,0,0,0,0,0,0,0,0,0,0,0,0,0,0,5,5
0,0,0,0,0,16,11,11,11,12,16,16,10,10,12,12,12,12,12,12,16,11,14,14,14,16,0,0,0,0,0,0,0,0,0,0,0,0,0,0,0,0,0,0,0
0,0,0,0,0,16,11,12,12,12,12,12,16,16,10,10,12,12,12,12,12,12,16,14,16,0,0,0,0,0,0,0,0,0,0,0,0,0,0,0,0,0,0,0,0
0,0,0,0,16,16,12,12,12,12,12,12,12,12,16,16,10,12,12,12,12,11,14,16,1,1,1,1,1,0,0,0,0,0,0,0,0,0,0,0,0,0,0,0,0
0,0,0,16,10,10,10,11,12,12,12,12,12,12,12,12,16,16,12,12,14,14,14,16,1,1,1,1,1,1,1,1,1,0,0,0,0,0,0,0,0,0,0,0,0
0,0,0,16,11,11,11,10,10,10,10,10,12,12,12,12,12,12,16,11,16,14,16,1,1,1,1,1,1,1,1,1,1,1,1,1,1,1,1,1,1,1,1,1,0
0,0,0,16,11,12,12,12,12,16,16,16,10,10,10,12,12,12,12,11,14,11,16,1,1,1,0,0,0,0,0,0,0,0,1,1,1,1,1,1,0,0,0,0,0
0,0,0,16,11,12,12,12,12,12,12,12,16,16,16,16,11,12,14,14,14,11,16,0,0,0,1,1,1,0,0,0,0,0,0,0,0,0,0,0,0,0,0,0,0
0,0,0,1,16,12,12,12,12,12,12,12,12,12,12,12,16,16,12,14,14,16,0,0,0,0,0,0,0,1,1,1,0,0,0,0,0,0,0,0,0,0,0,0,0
1,1,1,1,1,16,12,12,12,12,12,12,12,12,12,14,12,11,16,16,16,16,1,1,1,1,1,1,1,1,1,1,0,0,0,0,0,0,0,0,0,0,0,0,0
1,1,1,1,1,1,16,16,12,12,12,12,12,12,12,14,14,11,16,10,10,10,16,1,1,1,1,1,1,1,1,1,0,0,0,0,0,0,0,0,0,0,0,0,0
1,1,1,1,1,1,5,15,16,16,16,16,16,16,12,12,11,11,16,10,10,10,16,1,1,1,1,1,1,1,1,1,0,0,0,0,0,0,0,0,0,0,0,0,0
1,1,1,1,1,1,2,15,17,15,15,19,19,13,16,16,16,16,10,10,10,16,1,1,1,1,1,0,0,0,0,0,0,0,0,0,0,0,0,0,0,0,0,0,0
1,1,0,1,1,2,15,3,15,17,17,15,15,19,18,18,5,10,10,10,16,1,1,1,1,0,0,0,0,0,0,0,0,0,0,0,0,0,0,0,0,0,0,0,0
0,0,0,0,0,2,3,3,15,17,17,17,15,15,18,5,11,10,10,16,0,0,0,0,0,0,0,0,0,0,0,0,0,0,0,0,0,0,0,0,0,0,0,0,0
0,0,0,0,2,15,3,3,15,15,8,8,8,15,2,0,16,16,16,0,0,0,0,0,0,0,0,0,0,0,0,0,0,0,0,0,0,0,0,0,0,0,0,0,0
0,0,0,0,2,15,3,19,19,15,15,15,15,15,2,0,0,0,0,0,0,0,0,0,0,0,0,0,0,0,0,0,0,0,0,0,0,0,0,0,0,0,0,0,0
0,0,0,2,15,15,15,15,15,15,19,19,18,2,0,0,0,0,0,0,0,0,0,0,0,0,0,0,0,0,0,0,0,0,0,0,0,0,0,0,0,0,0,0,0
0,0,2,15,3,3,3,19,19,19,19,18,18,2,0,0,0,0,0,0,0,0,0,0,0,0,0,0,0,0,0,0,0,0,0,0,0,0,0,0,0,0,0,0,0
0,0,2,15,15,3,19,19,19,19,18,18,2,0,0,0,0,0,0,0,0,0,0,0,0,0,0,0,0,0,0,0,0,0,0,0,0,0,0,0,0,0,0,0,0
0,2,0,15,17,15,15,19,19,19,18,18,2,0,0,0,0,0,0,0,0,0,0,0,0,0,0,0,0,0,0,0,0,0,0,0,0,0,0,0,0,0,0,0,0
0,2,15,15,17,17,17,15,19,18,18,2,0,0,0,0,0,0,0,0,0,0,0,0,0,0,0,0,0,0,0,0,0,0,0,0,0,0,0,0,0,0,0,0,0
2,0,3,3,15,17,17,17,15,18,2,0,0,0,0,0,0,0,0,0,0,0,0,0,0,0,0,0,0,0,0,0,0,0,0,0,0,0,0,0,0,0,0,0,0
0,3,3,3,15,8,8,8,8,15,2,0,0,0,0,0,0,0,0,0,0,0,0,0,0,0,0,0,0,0,0,0,0,0,0,0,0,0,0,0,0,0,0,0,0
15,15,15,15,15,15,15,15,18,2,0,0,0,0,0,0,0,0,0,0,0,0,0,0,0,0,0,0,0,0,0,0,0,0,0,0,0,0,0,0,0,0,0,0,0
3,3,19,19,19,19,19,18,19,2,0,0,0,0,0,0,0,0,0,0,0,0,0,0,0,0,0,0,0,0,0,0,0,0,0,0,0,0,0,0,0,0,0,0,0
3,3,19,19,19,19,18,18,2,0,0,0,0,0,0,0,0,0,0,0,0,0,0,0,0,0,0,0,0,0,0,0,0,0,0,0,0,0,0,0,0,0,0,0,0
3,19,19,19,19,18,18,2,0,0,0,0,0,0,0,0,0,0,0,0,0,0,0,0,0,0,0,0,0,0,0,0,0,0,0,0,0,0,0,0,0,0,0,0,0
0,19,19,19,19,18,18,2,0,0,0,0,0,0,0,0,0,0,0,0,0,0,0,0,0,0,0,0,0,0,0,0,0,0,0,0,0,0,0,0,0,0,0,0,0
17,2,19,19,18,18,2,0,0,0,0,0,0,0,0,0,0,0,0,0,0,0,0,0,0,0,0,0,0,0,0,0,0,0,0,0,0,0,0,0,0,0,0,0,0
8,17,2,19,18,18,2,0,0,0,0,0,0,0,0,0,0,0,0,0,0,0,0,0,0,0,0,0,0,0,0,0,0,0,0,0,0,0,0,0,0,0,0,0,0
0.06666667,0.1176471,0.1254902
0.1568628,0.1960784,0.1882353
0.3098039,0.1960784,0.3686275
0.4235294,0.3568628,0.4588236
0.5215687,0.4352942,0.5647059
0.627451,0.3019608,0.1215686
0.7764707,0.372549,0.07450981
0.909804,0.5137255,0.2196079
0.9019608,0.5529412,0
0.9803922,0.6235294,0.3568628
1,0.7098039,0.7372549
1,0.7960785,0.8156863
1,0.8901961,0.8980393
1,0.9254903,0.9333334
1,0.937255,0.9411765
0.8392158,0.7686275,0.9137256
0.8196079,0.5411765,0.5686275
1,0.8352942,0.3960785
1,0.9686275,0.6392157
0.9803922,1,0.8313726