1
50-1
False,0
False,0
60,60
0,14,14,14,6,6,6,6,6,6,6,6,14,14,14,0,5,14,15,14,14,14,15,10,10,10,10,4,14,16,16,16,16,16,16,16,16,16,16,16,16,16,17,17,17,17,17,17,17,17,14,11,11,13,13,13,13,13,13,13
15,0,0,0,6,6,6,6,6,6,6,6,0,0,0,5,5,15,15,14,14,4,10,10,10,10,10,4,14,16,16,16,16,16,16,16,16,16,16,16,16,16,17,17,17,17,17,17,17,17,17,13,13,13,13,13,13,13,13,13
15,6,6,6,6,6,6,6,6,6,6,6,6,6,6,6,5,15,14,14,15,15,4,4,10,10,10,14,16,16,16,16,16,16,16,16,16,16,16,16,16,16,17,17,17,17,17,17,17,17,14,14,14,14,14,14,14,14,14,14
15,15,6,6,6,6,14,6,6,6,15,14,6,14,6,6,5,15,14,15,15,15,15,15,4,10,10,14,16,16,16,16,16,16,16,16,16,16,16,16,16,16,17,17,17,14,14,14,14,14,11,14,11,11,11,11,11,11,11,11
15,15,15,6,6,14,6,6,6,15,15,6,14,14,14,5,15,15,15,15,15,15,15,15,15,4,14,16,16,16,16,16,16,16,16,16,16,16,16,16,16,16,17,17,17,14,11,11,11,11,11,11,14,11,11,11,11,11,11,11
15,15,15,14,14,6,6,6,15,15,15,6,6,15,5,5,15,15,15,15,15,10,10,10,10,10,14,16,16,16,16,16,16,16,16,16,16,16,16,16,16,16,17,14,14,12,11,11,11,11,11,11,14,11,11,11,11,11,11,11
15,15,15,15,5,5,5,15,15,15,15,5,15,15,5,15,15,15,15,15,10,10,10,10,10,14,16,16,16,16,16,16,16,16,16,16,16,16,16,14,14,14,14,11,11,11,11,11,11,11,11,11,11,14,11,11,11,11,11,11
15,15,15,15,5,5,15,15,15,15,15,5,15,15,15,15,15,15,15,10,10,10,10,10,14,16,16,16,16,16,16,16,16,16,16,16,16,16,16,14,11,11,11,11,11,11,11,11,11,11,11,11,11,14,11,11,11,11,11,11
15,15,15,15,15,15,15,15,15,15,15,15,15,15,15,15,15,4,4,10,10,10,10,14,16,16,16,16,16,16,16,16,16,16,16,16,16,16,16,16,14,11,11,11,11,11,11,11,11,11,11,11,11,11,14,11,11,11,11,11
15,15,15,15,15,15,15,15,15,15,15,15,15,15,15,15,15,15,15,4,10,15,14,16,16,16,16,16,16,16,16,16,16,16,16,16,16,16,16,16,16,14,11,11,11,11,11,11,11,11,11,11,11,11,14,11,11,11,11,11
4,15,15,15,15,15,15,15,15,15,15,15,15,15,15,15,15,15,15,15,4,2,14,16,16,16,16,16,8,16,16,16,16,16,16,16,16,16,16,16,16,17,14,14,11,11,11,11,11,11,11,11,11,11,14,11,11,11,11,11
4,4,15,15,15,15,15,15,15,15,15,15,15,4,4,4,4,4,15,15,4,2,14,16,16,16,16,16,8,16,16,16,16,16,16,16,16,16,16,16,16,17,17,17,14,11,11,11,11,11,11,11,11,11,11,14,11,11,11,11
10,10,4,4,15,15,15,15,15,15,15,15,4,10,10,10,15,15,2,15,4,4,14,16,16,16,16,16,8,16,16,16,16,16,16,16,16,16,16,16,16,17,17,17,17,14,11,11,11,11,11,11,11,11,11,3,3,3,3,11
10,10,10,4,4,4,4,4,4,4,4,4,10,10,15,15,2,2,2,4,4,4,14,16,16,16,16,8,8,8,16,16,16,16,16,16,16,16,16,16,16,17,17,17,17,17,14,11,11,11,11,11,11,3,3,1,7,1,1,3
15,10,10,10,10,10,10,10,10,10,10,10,15,15,2,2,4,4,4,4,4,14,16,16,16,8,8,8,8,8,8,8,8,16,16,16,16,16,16,16,16,17,17,17,17,17,17,14,11,11,11,11,3,1,7,1,7,1,7,1
2,15,15,15,15,15,15,15,15,15,15,15,2,2,2,10,10,10,4,4,4,14,16,16,16,16,16,8,8,8,16,16,16,16,16,16,16,16,16,16,16,17,17,17,17,17,14,11,11,11,11,11,1,1,1,7,7,7,1,1
2,2,2,2,2,2,2,2,2,2,2,2,2,10,10,10,10,10,10,10,4,14,16,16,16,16,16,16,8,16,16,16,16,16,16,16,16,16,16,16,16,17,17,17,17,17,14,14,14,14,14,14,1,7,7,7,7,7,7,7
4,4,4,4,4,4,10,10,10,10,10,10,10,10,10,10,10,10,10,10,14,16,16,16,16,16,16,16,8,16,16,16,16,16,16,16,16,16,16,16,16,17,17,17,17,17,17,17,17,17,17,17,1,1,1,7,7,7,1,1
4,10,10,10,10,10,10,10,10,10,10,10,10,10,10,10,10,10,10,14,16,16,16,16,16,16,16,16,8,16,16,16,16,16,16,16,16,16,16,16,16,17,17,17,17,17,17,17,17,17,17,17,1,1,7,1,7,1,7,1
4,10,10,10,10,10,10,10,10,10,10,10,10,10,10,10,10,10,14,16,16,16,16,16,16,16,16,16,16,16,16,16,16,16,16,16,16,16,16,16,16,17,17,17,17,17,17,17,17,17,17,17,1,1,1,1,7,1,1,1
4,4,10,10,10,10,10,10,10,10,10,10,10,10,10,10,14,14,16,16,16,16,16,16,16,16,16,16,16,16,16,16,16,16,16,16,16,16,16,16,17,17,17,17,17,17,17,17,17,17,17,17,17,17,1,1,7,1,9,9
14,14,4,4,10,10,10,10,10,10,10,10,10,10,14,14,16,16,16,16,16,16,16,16,16,16,16,16,16,16,16,16,16,16,16,16,16,16,16,16,17,17,17,17,17,17,17,17,17,17,17,17,17,17,17,14,12,8,12,13
17,17,14,4,4,10,10,10,10,10,10,10,14,14,16,16,16,16,16,16,16,16,16,16,16,16,16,16,16,16,16,16,16,16,16,16,16,16,16,16,17,17,17,17,17,17,17,17,17,17,17,17,14,14,14,14,8,14,12,13
17,17,17,17,14,14,14,14,14,14,14,14,16,16,16,16,16,16,16,16,16,16,16,16,16,16,16,16,16,16,16,16,16,16,16,16,16,16,16,16,17,17,17,17,17,17,17,17,17,17,14,14,11,11,11,11,11,11,14,14
17,17,17,17,17,17,16,16,16,16,16,16,16,16,16,16,16,16,16,16,16,16,16,16,16,16,16,16,16,16,16,16,16,16,16,16,16,16,16,16,17,17,17,17,17,17,17,17,17,14,11,11,11,11,11,11,11,11,11,11
17,17,17,17,17,17,16,16,16,16,16,16,16,16,16,16,16,16,16,16,16,16,16,16,16,16,16,16,16,16,16,16,16,16,16,16,16,16,16,16,17,17,17,17,17,17,17,17,17,17,14,11,11,11,11,11,11,11,11,11
17,17,17,17,17,17,16,16,16,16,16,16,16,16,16,16,16,16,16,16,16,16,16,16,16,16,16,16,16,16,16,16,16,16,16,16,16,16,16,16,17,17,17,17,17,17,17,17,17,17,17,14,11,11,11,11,11,11,11,11
17,17,17,17,17,17,16,16,16,16,16,16,16,16,16,16,16,16,16,16,16,16,16,16,16,16,16,16,16,16,16,16,16,16,16,16,16,16,16,16,17,17,17,17,17,17,17,17,17,17,17,17,14,14,14,14,14,14,14,11
17,17,17,17,17,16,16,16,16,16,16,16,16,16,16,16,16,16,16,16,16,16,16,16,16,16,16,16,16,16,16,16,16,16,16,16,16,16,16,16,17,17,17,17,17,17,17,17,17,17,17,17,17,17,17,17,17,17,17,14
17,17,17,17,17,16,16,16,16,16,16,16,16,16,16,16,16,16,16,16,16,16,16,16,16,16,16,16,16,16,16,16,16,16,16,16,16,16,16,17,17,17,17,17,17,17,17,17,17,17,17,17,17,17,17,17,17,17,14,11
17,17,17,17,17,16,16,16,16,16,16,16,16,16,16,16,16,16,16,16,16,16,16,16,16,16,16,16,16,16,16,16,16,16,16,16,16,16,16,17,17,17,17,17,17,17,17,17,17,17,17,17,17,17,17,17,17,17,17,14
17,17,17,17,17,16,16,16,16,16,16,16,16,16,16,16,16,16,16,16,16,16,16,16,16,16,16,16,16,16,16,16,16,16,16,16,16,16,16,17,17,17,17,17,17,17,17,17,17,17,17,17,17,17,17,17,17,17,17,17
17,17,17,17,17,16,16,16,16,16,16,16,16,16,16,16,16,16,16,16,16,16,16,16,16,16,16,16,16,16,16,16,16,16,16,16,16,16,16,17,17,17,17,17,17,17,17,17,17,17,17,17,17,17,17,17,17,17,17,17
17,17,17,17,17,16,16,16,16,16,16,16,16,16,16,16,16,16,16,16,16,16,16,16,16,16,16,16,16,16,16,16,16,16,16,16,16,16,16,17,17,17,17,17,17,17,17,17,17,17,17,17,17,17,17,17,17,17,17,17
17,17,17,17,16,16,16,16,16,16,16,16,16,16,16,16,16,16,16,16,16,16,16,16,16,16,16,16,16,16,16,16,16,16,16,16,16,16,16,17,17,17,17,17,17,17,17,17,17,17,17,17,17,17,17,17,17,17,17,17
17,17,17,17,16,16,16,16,16,16,16,16,16,16,16,16,16,16,16,16,16,16,16,16,16,16,16,16,16,16,16,16,16,16,16,16,16,16,16,17,17,17,17,17,17,17,17,17,17,17,17,17,17,17,17,17,17,17,17,17
17,17,17,17,16,16,16,16,16,16,16,16,16,16,16,16,16,16,16,16,16,16,16,16,16,16,16,16,16,16,16,16,16,16,16,16,16,16,16,17,17,17,17,17,17,17,17,17,17,17,17,17,17,17,17,17,17,17,17,17
17,17,17,16,16,16,16,16,16,16,16,16,16,16,16,16,16,16,16,16,16,16,16,16,16,16,16,16,16,16,16,16,16,16,16,16,16,16,16,17,17,17,17,17,17,17,17,17,17,17,17,17,17,17,17,17,17,17,17,17
17,17,17,16,16,16,16,16,16,16,16,16,16,16,16,16,16,16,16,16,16,16,16,16,16,16,16,16,16,16,16,16,16,16,16,16,16,16,17,17,17,17,17,17,17,17,17,17,17,17,17,17,17,17,17,17,17,17,17,17
17,17,17,16,16,16,16,16,16,16,16,16,16,16,16,16,16,16,16,16,16,16,16,16,16,16,16,16,16,16,16,16,16,16,16,16,16,16,17,17,17,17,17,17,17,17,17,17,17,17,17,17,17,17,17,17,17,17,17,17
17,17,16,16,16,16,16,16,16,16,16,16,16,16,16,16,16,16,16,16,16,16,16,16,16,16,16,16,16,16,16,16,16,16,16,16,16,16,17,17,17,17,17,17,17,17,17,17,17,17,17,17,17,17,17,17,17,17,17,17
17,17,16,16,16,16,16,16,16,16,16,16,16,16,16,16,16,16,16,16,16,16,16,16,16,16,16,16,16,16,16,16,16,16,16,16,16,16,17,17,17,17,17,17,17,17,17,17,17,17,17,17,17,17,17,17,17,17,17,17
17,17,16,16,16,16,16,16,16,16,16,16,16,16,16,16,16,16,16,16,16,16,16,16,16,16,16,16,16,16,16,16,16,16,16,16,16,16,17,17,17,17,17,17,17,17,17,17,17,17,17,17,17,17,17,17,17,17,17,17
17,17,16,16,16,16,16,16,16,16,16,16,16,16,16,16,16,16,16,16,16,16,16,16,16,16,16,16,16,16,16,16,16,16,16,16,16,16,17,17,17,17,17,17,17,17,17,17,17,17,17,17,17,8,17,17,17,17,17,17
17,17,16,16,16,16,16,16,16,16,16,16,16,16,16,16,16,16,16,16,16,16,16,16,16,16,16,16,16,16,16,16,16,16,16,16,16,16,17,17,17,17,17,17,17,17,17,17,17,17,17,17,17,8,17,17,17,17,17,17
17,17,16,16,16,16,16,16,16,16,16,16,16,16,16,16,16,16,16,16,16,16,16,16,16,16,16,16,16,16,16,16,16,16,16,16,16,16,17,17,17,17,17,17,17,17,17,17,17,17,17,17,17,8,17,17,17,17,17,17
17,16,16,16,16,16,16,16,16,16,16,16,16,16,16,16,16,16,16,16,16,16,16,16,16,16,16,16,16,16,16,16,16,16,16,16,16,16,17,17,17,17,17,17,17,17,17,17,17,17,17,17,17,8,17,17,17,17,17,17
17,16,16,16,16,16,16,16,16,16,16,16,16,16,16,16,16,16,16,16,16,16,16,16,16,16,16,16,16,16,16,16,16,16,16,16,16,17,17,17,17,17,17,17,17,17,17,17,17,8,17,17,17,8,17,17,17,8,17,17
17,16,16,16,16,16,16,16,16,16,16,16,16,16,16,16,16,16,16,16,16,16,16,16,16,16,16,16,16,16,16,16,16,16,16,16,16,17,17,17,17,17,17,17,17,17,17,17,17,17,8,17,17,8,17,17,8,17,17,17
16,16,16,16,16,16,16,16,16,16,16,16,16,16,16,16,16,16,16,16,16,16,16,16,16,16,16,16,16,16,16,16,16,16,16,16,16,17,17,17,17,17,17,17,17,17,17,17,17,17,17,8,17,8,17,8,17,17,17,17
16,16,16,16,16,16,16,16,16,16,16,16,16,16,16,16,16,16,16,16,16,16,16,16,16,16,16,16,16,16,16,16,16,16,16,16,16,17,17,17,17,17,17,17,17,17,17,17,17,17,17,17,8,8,8,17,17,17,17,17
16,16,16,16,16,16,16,16,16,16,16,16,16,16,16,16,16,16,16,16,16,16,16,16,16,16,16,16,16,16,16,16,16,16,16,16,16,17,17,17,17,17,17,17,17,8,8,8,8,8,8,8,8,8,8,8,8,8,8,8
16,16,16,16,16,16,16,16,16,16,16,16,16,16,16,16,16,16,16,16,16,16,16,16,16,16,16,16,16,16,16,16,16,16,16,16,16,17,17,17,17,17,17,17,17,17,17,17,17,17,17,17,8,8,8,17,17,17,17,17
16,16,16,16,16,16,16,16,16,16,16,16,16,16,16,16,16,16,16,16,16,16,16,16,16,16,16,16,16,16,16,16,16,16,16,16,16,17,17,17,17,17,17,17,17,17,17,17,17,17,17,8,17,8,17,8,17,17,17,17
16,16,16,16,16,16,16,16,16,16,16,16,16,16,16,16,16,16,16,16,16,16,16,16,16,16,16,16,16,16,16,16,16,16,16,16,16,17,17,17,17,17,17,17,17,17,17,17,17,17,17,17,17,8,17,17,8,17,17,17
16,16,16,16,16,16,16,16,16,16,16,16,16,16,16,16,16,16,16,16,16,16,16,16,16,16,16,16,16,16,16,16,16,16,16,16,16,17,17,17,17,17,17,17,17,17,17,17,17,17,17,17,17,8,17,17,17,8,17,17
16,16,16,16,16,16,16,16,16,16,16,16,16,16,16,16,16,16,16,16,16,16,16,16,16,16,16,16,16,16,16,16,16,16,16,16,16,17,17,17,17,17,17,17,17,17,17,17,17,17,17,17,17,8,17,17,17,17,17,17
16,16,16,16,16,16,16,16,16,16,16,16,16,16,16,16,16,16,16,16,16,16,16,16,16,16,16,16,16,16,16,16,16,16,16,16,16,17,17,17,17,17,17,17,17,17,17,17,17,17,17,17,17,8,17,17,17,17,17,17
16,16,16,16,16,16,16,16,16,16,16,16,16,16,16,16,16,16,16,16,16,16,16,16,16,16,16,16,16,16,16,16,16,16,16,16,16,17,17,17,17,17,17,17,17,17,17,17,17,17,17,17,17,8,17,17,17,17,17,17
16,16,16,16,16,16,16,16,16,16,16,16,16,16,16,16,16,16,16,16,16,16,16,16,16,16,16,16,16,16,16,16,16,16,16,16,17,17,17,17,17,17,17,17,17,17,17,17,17,17,17,17,17,8,17,17,17,17,17,17
1,0.5607843,0.5019608
0.9725491,0.3333333,0.372549
0.9215687,0.2588235,0.3019608
0.8274511,0.1215686,0.1647059
0.9176471,0.572549,0.2666667
1,0.7450981,0.6352941
1,0.854902,0.7921569
1,0.9137256,0.9333334
0.9960785,0.9529412,0.854902
0.9764706,0.9058824,0.4980392
1,0.8156863,0.3176471
0.3568628,0.7568628,0.5019608
0.1215686,0.6980392,0.3333333
0.06666667,0.5490196,0.1568628
0,0.2352941,0.3921569
0.4980392,0.2156863,0.2745098
0.4784314,0.7098039,1
0.4078432,0.6705883,1