1
50-2
False,0
False,0
60,60
0,0,0,0,0,0,0,0,9,9,1,1,1,1,1,1,1,1,1,0,0,0,0,0,0,0,0,0,1,1,1,1,1,1,1,1,1,9,2,2,9,10,10,10,10,10,10,10,10,10,10,10,10,10,10,10,10,10,10,10
0,0,0,0,0,9,9,9,1,1,1,1,1,1,1,1,1,1,1,0,0,0,0,0,0,0,0,0,1,1,1,1,1,1,1,1,1,0,9,2,10,10,10,10,10,10,10,10,10,10,10,10,10,10,10,10,10,10,10,10
9,9,9,9,9,1,1,1,1,1,1,1,1,1,1,1,1,1,1,0,0,0,0,0,0,0,0,0,1,1,1,1,1,1,1,1,1,0,2,9,9,10,10,10,10,10,10,10,10,10,10,10,10,10,10,10,10,10,10,10
2,1,1,1,1,1,1,1,1,1,1,1,1,1,1,1,1,1,1,0,0,0,0,0,0,0,0,0,1,1,1,1,1,1,1,1,1,0,0,0,2,9,9,9,9,9,10,10,10,10,10,10,10,10,10,10,10,10,10,10
2,2,1,1,1,1,1,1,1,1,1,1,1,1,1,1,1,1,1,0,0,0,0,0,0,0,0,1,1,1,1,1,1,1,1,1,1,0,0,0,2,2,2,2,2,9,10,10,10,10,10,10,10,10,10,10,10,10,10,10
2,2,1,1,1,1,1,1,1,1,1,1,1,1,1,1,1,1,1,0,0,0,0,0,0,0,0,1,1,1,1,1,1,1,1,1,0,0,0,2,2,2,2,2,2,2,9,9,10,10,10,10,10,10,10,10,10,10,10,10
2,2,1,1,1,1,1,1,1,1,1,1,1,1,1,1,1,1,1,0,0,0,0,0,0,0,0,1,1,1,1,1,1,1,1,1,0,0,0,2,2,2,2,2,2,0,0,0,9,9,9,9,10,10,10,10,10,10,10,10
2,2,1,1,1,1,1,1,1,1,1,1,1,1,1,1,1,1,1,0,0,0,0,0,0,0,0,1,1,1,1,1,1,1,0,0,0,0,2,2,2,2,2,2,0,0,0,0,0,0,0,9,10,10,10,10,10,10,10,10
2,2,2,1,1,1,1,1,1,1,1,1,1,1,1,1,1,1,1,0,0,0,0,0,0,0,0,1,1,1,1,1,1,1,0,0,0,0,2,2,2,2,2,0,0,0,0,0,0,0,9,10,10,10,10,10,10,10,10,10
2,2,2,1,1,1,1,1,1,1,1,1,1,1,1,1,1,1,1,0,0,0,0,0,0,0,1,1,1,1,1,1,1,1,0,0,0,0,2,2,2,2,0,0,0,0,0,0,0,9,10,10,10,10,10,10,10,10,10,10
2,2,2,1,1,1,1,1,1,1,1,1,1,1,1,1,1,1,1,0,0,0,0,0,0,0,1,1,1,1,1,1,1,0,0,0,0,0,2,2,2,2,0,0,0,0,0,9,9,10,10,10,10,10,10,10,10,10,10,10
2,2,2,1,1,1,1,1,1,1,1,1,1,1,1,1,1,1,1,0,0,0,0,0,0,0,1,1,1,1,1,1,1,0,0,0,0,0,2,2,2,0,0,0,0,0,9,10,10,10,10,10,10,10,10,10,10,10,10,10
2,2,2,1,1,1,1,1,1,1,1,1,1,1,1,1,1,1,1,0,0,0,0,0,0,0,1,1,1,1,1,1,0,0,0,0,0,0,0,0,0,0,0,0,0,9,10,10,10,10,10,10,10,10,10,10,10,10,10,10
7,2,2,1,1,1,1,1,1,1,1,1,1,1,1,1,1,1,1,0,0,0,0,0,0,1,1,1,1,1,1,1,0,0,0,0,0,0,0,0,0,0,0,0,9,10,10,10,10,10,10,10,10,10,10,10,10,10,10,10
7,2,2,2,1,1,1,1,1,1,1,1,1,1,1,1,1,1,1,0,0,0,0,0,0,1,1,1,1,3,6,6,6,6,0,0,0,0,0,0,0,0,0,9,10,10,10,10,10,10,10,10,10,10,10,10,10,10,10,10
8,7,2,2,1,1,1,1,1,1,1,1,1,1,1,1,1,1,1,0,0,0,0,0,0,1,1,1,1,3,3,3,6,6,0,0,0,0,0,0,0,0,0,0,9,10,10,10,10,10,10,10,10,10,10,10,10,10,10,10
8,7,2,2,1,1,1,1,1,1,1,1,1,1,1,1,1,1,1,0,0,0,0,0,0,1,1,1,0,3,3,3,3,6,0,0,0,0,9,9,9,9,9,9,9,11,10,10,10,10,10,10,10,10,10,10,10,10,10,10
8,7,2,2,1,3,3,3,3,3,3,3,3,6,1,1,1,1,0,0,0,0,0,0,0,0,0,0,0,3,3,3,3,3,0,0,0,9,11,11,11,11,11,11,11,11,11,10,10,10,10,10,10,10,10,10,10,10,10,10
8,7,6,6,6,0,0,0,0,0,0,0,0,1,6,6,6,1,0,0,0,0,0,0,0,0,0,0,0,3,3,3,3,3,0,0,9,11,11,11,11,11,11,11,11,11,11,10,10,10,10,10,10,10,10,10,10,10,10,10
6,6,2,2,0,0,0,0,0,0,0,0,0,0,0,0,0,6,6,0,0,0,0,0,0,0,0,0,0,0,0,0,6,0,0,9,11,11,11,11,11,11,11,11,11,11,11,11,10,10,10,10,10,10,10,10,10,10,10,10
1,1,0,0,0,0,0,9,9,0,0,0,0,0,0,0,0,0,0,3,0,0,0,0,0,0,0,0,0,9,9,9,0,0,0,9,11,11,11,11,11,11,11,11,11,11,11,11,10,10,10,10,10,10,10,10,10,10,10,10
0,0,0,0,0,9,9,2,2,9,9,0,0,0,0,9,9,9,0,0,6,0,0,0,0,9,9,9,9,2,1,1,9,9,0,9,11,11,11,11,11,11,11,11,11,11,11,11,10,10,10,10,10,10,10,10,10,10,10,10
0,0,0,9,9,2,2,2,2,2,2,9,9,9,9,2,2,2,9,0,0,9,9,9,9,2,1,1,1,1,1,1,1,1,9,9,9,9,9,11,11,11,11,11,11,11,11,11,11,10,10,10,10,10,10,10,10,10,10,10
0,9,9,2,2,2,2,2,2,2,2,2,2,2,2,2,2,2,2,9,9,2,1,1,1,1,1,1,1,1,1,1,1,1,1,1,1,1,1,9,9,11,11,11,11,11,11,11,11,11,10,10,10,10,10,10,10,10,10,10
9,2,2,2,2,2,2,2,2,2,2,2,2,2,2,2,2,2,2,2,2,2,1,1,1,1,1,1,1,1,1,1,1,1,1,1,1,1,1,1,2,9,11,11,11,11,11,11,11,11,10,10,10,10,10,10,10,10,10,10
2,2,2,2,2,2,2,2,2,2,2,2,2,2,2,2,2,2,2,2,2,2,1,1,1,1,1,1,1,1,1,1,1,1,1,1,1,1,1,1,9,11,11,11,11,11,11,11,11,11,11,10,10,10,10,10,10,10,10,10
2,2,2,2,2,2,2,2,2,2,2,2,2,2,2,2,2,2,2,2,2,2,1,1,1,1,1,1,1,1,1,1,1,1,1,1,1,1,1,9,11,11,11,11,11,11,11,11,11,11,11,11,10,10,10,10,10,10,10,10
2,2,2,2,2,2,2,2,2,2,2,2,2,2,2,2,2,2,2,2,2,2,1,1,1,1,1,1,1,1,1,1,9,9,9,9,9,9,9,11,11,11,11,11,11,11,11,11,11,11,11,11,11,10,10,10,10,10,10,10
2,2,2,2,2,2,2,2,2,2,2,2,2,2,2,2,2,2,2,2,2,2,1,1,1,1,1,1,1,1,1,9,11,11,11,11,11,11,11,11,11,11,11,11,11,11,11,11,11,11,11,11,11,11,10,10,10,10,10,10
2,2,2,2,2,2,2,2,2,2,2,2,2,2,2,2,2,2,2,2,2,2,1,1,1,1,1,1,1,1,1,1,9,11,11,11,11,11,11,11,11,11,11,11,11,11,11,11,11,11,11,11,11,11,10,10,10,10,10,10
9,9,9,2,2,2,2,2,2,2,2,2,2,2,2,2,2,2,2,2,2,1,1,1,1,1,1,1,9,9,9,9,11,11,11,11,11,11,11,11,11,11,11,11,11,11,11,11,11,11,11,11,11,11,10,10,10,10,10,10
10,10,9,2,2,2,2,2,2,2,2,2,2,2,2,2,2,2,2,2,2,1,1,1,1,1,1,1,9,10,10,10,11,11,11,11,11,11,11,11,11,11,11,11,11,11,11,11,11,11,11,11,11,11,11,10,10,10,10,10
11,10,9,2,2,2,2,2,2,2,2,2,2,2,2,2,2,2,2,2,2,1,1,1,1,1,1,1,9,10,10,10,11,11,11,11,11,11,11,11,11,11,11,11,11,11,11,11,11,11,11,11,11,11,11,11,10,10,10,10
11,10,9,2,2,2,2,2,2,2,2,2,2,2,2,2,2,2,2,2,2,1,1,1,1,1,1,1,9,10,10,10,11,11,11,11,11,11,11,11,11,11,11,11,11,11,11,11,11,11,11,11,11,11,11,11,10,10,10,10
11,9,2,2,2,2,2,2,2,2,2,2,2,2,2,2,2,2,2,2,2,1,1,1,1,1,1,1,1,9,10,10,10,11,11,11,11,11,11,11,11,11,11,11,11,11,11,11,11,11,11,11,11,11,11,11,11,10,10,10
11,10,9,9,2,2,2,2,2,2,2,2,2,2,2,2,2,2,2,2,1,1,1,1,1,1,1,9,9,10,10,10,10,11,11,11,11,11,11,11,11,11,11,11,11,11,11,11,11,11,11,11,11,11,11,11,11,11,10,10
11,10,10,10,9,2,2,2,2,2,2,2,2,2,2,2,2,2,1,1,1,1,1,1,1,1,9,10,10,10,10,10,10,11,11,11,11,11,11,11,11,11,11,11,11,11,11,11,11,11,11,11,11,11,11,11,11,11,10,10
11,10,10,10,10,9,9,9,9,2,2,2,2,2,2,2,2,1,1,1,1,1,9,9,9,9,10,10,10,10,10,10,10,10,11,11,11,11,11,11,11,11,11,11,11,11,11,11,11,11,11,11,11,11,11,11,11,11,11,10
11,10,10,10,10,10,10,10,9,2,2,2,2,2,2,2,2,1,1,1,1,1,9,10,10,10,10,10,10,10,10,10,10,10,11,11,11,11,11,11,11,11,11,11,11,11,11,11,11,11,11,11,11,11,11,11,11,11,11,10
11,10,10,10,10,10,10,10,9,9,2,2,2,2,2,2,1,1,1,1,1,9,9,10,10,10,10,10,10,10,10,10,10,10,11,11,11,11,11,11,11,11,11,11,11,11,11,11,11,11,11,11,11,11,11,11,11,11,11,10
11,10,10,10,10,10,10,10,10,10,9,2,2,2,2,2,1,1,1,1,9,10,10,10,10,10,10,3,10,10,10,10,10,10,10,11,11,11,11,11,11,11,11,11,11,11,11,11,11,11,11,11,11,11,11,11,11,11,11,11
11,11,10,10,10,10,10,10,10,10,10,9,2,2,2,2,1,1,1,9,10,10,10,10,10,10,10,3,10,10,10,10,10,10,10,11,11,11,11,11,11,11,11,11,11,11,11,11,11,11,11,11,11,11,11,11,11,11,11,11
11,11,10,10,10,10,10,10,10,10,10,10,9,2,2,1,1,1,9,10,10,10,10,10,10,10,10,3,10,10,10,10,10,10,10,10,11,11,11,11,11,11,11,11,11,11,11,11,11,11,11,11,11,11,11,11,11,11,11,11
11,11,10,10,10,10,10,10,10,10,10,10,9,9,2,1,1,1,9,10,10,10,10,10,10,10,3,3,3,10,10,10,10,10,10,10,11,11,11,11,11,11,11,11,11,11,11,11,11,11,11,11,11,11,11,11,11,11,11,11
11,11,10,10,10,10,10,10,10,10,10,10,10,9,2,1,1,9,10,10,10,10,10,10,3,3,3,3,3,3,3,3,10,10,10,10,11,11,11,11,11,11,11,11,11,11,11,11,11,11,11,11,11,11,11,11,11,11,11,11
11,11,10,10,10,10,10,10,10,10,10,9,9,10,9,1,9,11,9,9,10,10,10,10,10,10,3,3,3,10,10,10,10,10,10,10,10,11,11,11,11,11,11,11,11,11,11,11,11,11,11,11,11,11,11,11,11,11,11,11
11,11,10,10,10,10,10,10,10,10,10,9,4,9,10,9,11,9,3,9,10,10,10,10,10,10,10,3,10,10,10,10,10,10,10,10,10,11,11,11,11,11,11,11,11,11,11,11,11,11,11,11,11,11,11,11,11,11,11,11
11,11,11,10,10,10,10,10,10,10,10,9,5,5,9,5,5,5,3,9,10,10,10,10,10,10,10,3,10,10,10,10,10,10,10,10,10,11,11,11,11,11,11,11,11,11,11,11,11,11,11,11,11,11,11,11,11,11,11,11
11,11,11,10,10,10,10,10,10,10,10,9,5,5,5,5,5,5,3,9,10,10,10,10,10,10,10,3,10,10,10,10,10,10,10,10,10,10,11,11,11,11,11,11,11,11,11,11,11,11,11,11,11,11,11,11,11,11,11,11
11,11,11,10,10,10,10,10,10,10,10,9,5,5,5,5,5,5,3,9,10,10,10,10,10,10,10,10,10,10,10,10,10,10,10,10,10,10,11,11,11,11,11,11,11,11,11,11,11,11,11,11,11,11,11,11,11,11,11,11
11,11,11,10,10,10,10,10,10,10,10,9,5,5,5,5,5,5,3,9,10,10,10,10,10,10,10,10,10,10,10,10,10,10,10,10,10,10,11,11,11,11,11,11,11,11,11,11,11,11,11,11,11,11,11,11,11,11,11,11
3,3,11,10,10,10,10,10,10,9,9,4,5,5,5,5,5,5,5,5,9,9,10,10,10,10,10,10,10,10,10,10,10,10,10,10,10,10,10,11,11,11,11,11,11,11,11,11,11,11,11,11,11,11,11,11,11,11,11,11
11,11,11,10,10,10,10,10,9,3,4,4,4,4,5,5,5,5,5,5,5,5,9,10,10,10,10,10,10,10,10,10,10,10,10,10,10,10,10,11,11,11,11,11,11,11,11,11,11,11,11,11,11,11,11,11,11,11,11,11
11,11,11,11,10,10,10,9,3,4,4,4,4,4,4,4,5,5,5,4,4,5,5,9,10,10,10,10,10,10,10,10,10,10,10,10,10,10,10,11,11,11,11,11,11,11,11,11,11,11,11,11,11,11,11,11,11,11,11,11
11,11,11,11,10,10,10,10,9,9,9,9,9,3,4,4,4,4,9,9,9,9,9,10,10,10,10,10,10,10,10,10,10,10,10,10,10,10,10,11,11,11,11,11,11,11,11,11,11,11,11,11,11,11,11,11,11,11,11,11
11,11,11,11,10,10,10,10,10,10,10,10,10,9,3,4,4,9,11,11,11,10,10,10,10,10,10,10,10,10,10,10,10,10,10,10,10,10,10,11,11,11,11,11,11,11,11,11,11,11,11,11,11,11,11,11,11,11,11,11
11,11,11,11,10,10,10,10,10,10,10,10,10,9,3,4,4,9,11,11,11,11,10,10,10,10,10,10,10,10,10,10,10,10,10,10,10,10,10,10,11,11,11,11,11,11,11,11,11,11,11,11,11,11,11,11,11,11,11,11
11,11,11,11,10,10,10,10,10,10,10,10,10,10,9,4,9,11,11,11,11,11,10,10,10,10,10,10,10,10,10,10,10,10,10,10,10,10,10,10,11,11,11,11,11,11,11,11,11,11,11,11,11,11,11,11,11,11,11,11
11,11,11,11,10,10,10,10,10,10,10,10,10,10,10,9,10,11,11,11,11,11,10,10,10,10,10,10,10,10,10,10,10,10,10,10,10,10,10,10,10,11,11,11,11,11,11,11,11,11,11,11,11,11,11,11,11,11,11,11
11,11,11,11,11,10,10,10,10,10,10,10,10,10,10,10,10,11,11,11,11,11,10,10,10,10,10,10,10,10,10,10,10,10,10,10,10,10,10,10,10,11,11,11,11,11,11,11,11,11,11,11,11,11,11,11,11,11,11,11
0.06666667,0.5490196,0.1568628
0.1215686,0.6980392,0.3333333
0.3568628,0.7568628,0.5019608
0.9960785,0.9529412,0.854902
1,0.8431373,0.4235294
1,0.8156863,0.3176471
0.9764706,0.9058824,0.4980392
0.8274511,0.1215686,0.1647059
0.9725491,0.3333333,0.372549
0,0.2352941,0.3921569
0.4784314,0.7098039,1
0.4078432,0.6705883,1