1
62-1
False,0
False,0
45,45
0,0,0,0,2,2,3,3,3,3,3,3,3,3,3,3,2,2,2,2,2,2,2,2,2,2,2,2,2,2,2,2,2,2,2,3,3,3,4,4,4,4,4,4,4
0,0,0,0,0,2,4,4,4,4,4,4,4,4,3,3,3,3,3,3,3,3,3,3,3,3,3,3,3,3,3,3,3,3,3,3,3,3,4,4,4,4,4,4,4
7,7,7,7,7,2,4,4,4,4,4,4,4,4,4,4,4,4,3,3,3,3,3,3,3,3,3,3,4,4,3,3,3,4,4,4,4,4,4,4,4,4,4,4,4
7,7,7,7,7,2,4,4,4,4,4,4,4,4,4,4,4,4,4,4,4,3,3,3,3,3,3,4,4,4,3,4,4,4,4,4,4,4,4,4,4,4,4,3,4
11,11,7,7,7,2,4,4,3,3,4,4,4,4,4,4,4,4,4,4,4,4,4,4,4,4,4,4,4,4,4,4,4,4,4,4,4,4,4,4,4,4,3,3,5
12,11,11,7,7,2,3,3,3,3,3,4,4,4,4,4,4,4,4,4,4,4,4,4,4,4,4,4,4,4,4,4,4,4,4,4,4,4,4,4,4,4,3,3,5
11,11,7,7,7,2,3,3,3,4,5,5,4,4,4,4,4,4,4,4,4,4,4,4,4,4,4,4,4,4,4,4,4,4,4,4,4,4,4,3,3,3,3,3,5
12,11,7,7,7,2,3,3,5,5,5,4,4,4,4,4,4,4,4,4,4,4,4,4,4,4,4,4,4,3,3,3,3,3,4,4,4,4,3,3,5,5,5,3,5
12,11,7,7,7,7,2,4,5,4,5,5,5,5,5,5,5,5,5,4,4,4,4,4,4,4,4,4,3,3,3,3,3,3,3,4,4,4,5,5,5,5,5,5,5
12,11,7,7,7,7,2,5,5,5,5,5,5,5,5,5,5,5,5,5,4,4,4,4,4,4,4,4,3,5,5,3,3,3,3,4,4,4,5,5,5,5,5,5,5
12,11,7,7,7,7,7,2,5,5,5,5,5,5,5,5,5,5,5,5,5,4,4,4,4,4,4,4,4,5,5,5,5,5,3,4,5,5,5,5,5,5,5,5,2
12,11,9,9,9,9,9,9,2,2,5,5,5,5,5,5,5,5,5,5,5,5,4,4,4,4,4,4,4,4,4,4,4,4,4,5,5,5,5,5,5,5,5,2,7
11,10,10,8,8,8,8,8,9,9,2,5,5,5,5,5,5,5,5,5,5,5,5,5,5,5,5,5,4,4,4,4,4,4,4,5,5,5,5,5,5,5,2,7,7
9,9,9,10,10,10,8,8,8,8,8,2,5,5,5,5,5,5,5,5,5,5,5,5,5,5,5,5,5,5,5,5,5,5,5,5,5,5,5,2,2,2,7,7,7
7,7,7,9,10,10,10,10,8,8,8,8,2,2,2,2,5,5,5,5,5,5,5,5,5,5,5,5,5,5,5,5,5,5,5,5,2,2,2,2,9,7,7,7,7
7,7,7,7,9,10,10,10,10,8,8,8,8,8,8,10,2,2,2,5,5,2,2,5,5,2,5,5,2,2,5,5,2,2,2,2,10,10,10,10,9,7,7,7,7
7,7,7,7,7,9,10,10,10,10,8,8,8,8,8,8,10,10,10,2,2,10,10,2,2,10,2,2,10,10,2,2,10,10,10,10,10,10,10,10,9,7,7,7,7
6,6,7,7,7,7,9,10,10,10,10,8,8,8,8,8,8,10,10,10,10,10,10,10,10,10,10,10,10,10,10,10,10,10,10,10,10,10,10,9,7,7,7,7,7
6,6,7,7,7,7,9,10,10,10,10,10,8,8,8,8,8,8,10,10,10,10,10,10,10,10,10,10,10,10,10,10,10,10,10,10,10,10,10,9,7,7,7,7,7
6,6,6,6,7,7,7,9,10,10,10,10,10,8,8,8,8,8,8,10,10,10,10,10,10,10,10,10,10,10,10,10,10,10,10,10,10,11,9,7,7,7,7,7,7
6,6,6,6,6,6,6,9,10,10,10,10,10,8,8,8,8,8,8,8,8,10,10,10,10,10,10,10,10,10,10,10,10,10,10,11,11,10,9,7,7,7,7,7,7
6,6,6,6,6,6,6,9,10,10,10,10,10,10,8,8,8,8,8,8,8,8,8,10,10,10,10,10,10,10,10,10,10,10,11,11,10,9,6,7,6,6,6,6,6
6,6,6,6,6,6,6,6,9,10,10,10,10,10,8,8,8,8,8,10,8,8,8,8,8,8,10,10,10,10,10,11,11,11,11,10,10,9,6,6,6,6,6,6,6
6,6,6,6,6,6,6,6,9,10,10,10,10,10,8,8,8,8,8,8,10,10,10,10,10,10,10,10,10,10,11,11,11,11,10,10,9,6,6,6,6,6,7,7,6
6,6,6,6,6,6,6,6,9,10,10,10,10,10,8,8,8,8,10,8,8,8,8,10,10,10,10,10,10,11,11,11,11,10,10,9,6,6,6,6,6,6,6,6,6
6,6,6,6,6,6,6,6,6,9,10,10,10,10,10,8,8,10,10,10,10,10,10,10,10,10,10,10,11,11,11,11,10,10,9,6,6,6,7,6,6,6,6,6,6
6,6,6,6,6,6,6,6,6,9,10,10,10,10,10,8,8,10,10,10,10,10,10,10,10,10,10,10,11,11,11,10,10,9,6,6,6,6,6,6,6,6,6,6,6
6,6,6,6,6,6,6,6,6,6,9,10,10,10,10,8,8,10,10,10,10,10,10,10,10,10,10,10,11,11,10,10,9,6,6,6,6,6,6,6,6,6,6,6,6
6,6,6,6,6,6,6,6,6,6,9,10,10,10,10,10,8,8,8,8,10,10,10,10,10,10,10,11,11,10,10,9,6,6,6,6,6,6,6,6,6,6,6,6,6
6,6,6,6,6,6,6,6,6,6,6,9,10,10,10,10,10,10,10,10,10,10,10,10,10,10,11,11,10,10,9,6,6,6,6,6,6,6,6,6,6,6,6,6,6
6,6,6,6,6,6,6,6,6,6,6,6,9,10,10,10,10,10,10,10,10,10,10,10,10,11,11,10,10,9,6,6,6,6,6,6,6,6,6,6,6,6,6,6,6
6,6,6,4,6,6,6,6,6,6,6,6,6,9,10,10,10,10,10,10,10,10,10,10,11,10,10,9,9,6,6,6,6,6,6,6,6,6,6,6,6,6,6,6,6
6,6,6,6,6,6,6,6,6,6,6,6,6,6,9,9,10,10,10,10,10,10,10,10,9,9,9,6,6,6,6,6,6,6,6,6,6,6,6,6,6,6,6,6,6
6,6,6,6,6,6,6,6,6,6,6,6,6,6,6,6,9,9,9,9,9,9,9,9,6,6,6,6,6,6,6,6,6,6,6,6,6,6,6,6,6,6,6,6,6
6,6,6,6,6,6,6,6,6,6,6,6,6,6,6,6,6,6,6,6,6,6,6,6,6,6,6,6,6,6,6,6,6,6,6,6,6,6,6,6,6,6,6,6,6
6,6,6,6,6,6,6,6,6,6,6,6,6,6,6,6,6,6,6,6,6,6,6,6,6,6,6,6,6,6,6,6,6,6,6,6,6,6,6,6,6,6,6,6,6
6,6,6,6,6,6,6,6,6,6,6,6,6,6,6,6,6,6,6,6,6,6,6,6,6,6,6,6,6,6,6,6,6,6,6,6,6,6,6,6,6,6,6,6,6
6,6,6,6,6,6,6,6,6,6,6,6,6,6,6,6,6,6,6,6,6,6,6,6,6,6,6,6,6,6,6,6,6,6,6,6,6,6,6,6,6,6,6,6,6
6,6,6,6,6,6,6,6,6,6,6,6,6,6,6,6,6,6,6,6,6,6,6,6,6,6,6,6,6,6,6,6,6,6,6,6,6,6,6,6,6,6,6,6,6
6,6,6,6,6,6,6,6,6,6,6,6,6,6,6,6,6,6,6,6,6,6,6,6,6,6,6,6,6,6,6,6,6,6,6,6,6,6,6,6,6,6,6,6,6
6,6,6,6,6,6,6,6,6,6,6,6,6,6,6,6,6,6,6,6,6,6,6,6,6,6,6,6,6,6,6,6,6,6,6,6,6,6,6,6,6,6,6,6,6
6,6,6,6,6,6,6,6,6,6,6,6,6,6,6,6,6,6,6,6,6,6,6,6,6,6,6,6,6,6,6,6,6,6,6,6,6,6,6,6,6,6,6,6,6
6,6,6,6,6,6,6,6,6,6,6,6,6,6,6,6,6,6,6,6,6,6,6,6,6,6,6,6,6,6,6,6,6,6,6,6,6,6,6,6,6,6,6,6,6
6,6,6,6,6,6,6,6,6,6,6,6,6,6,6,6,6,6,6,6,6,6,6,6,6,6,6,6,6,6,6,6,6,6,6,6,6,6,6,6,6,6,6,6,6
6,6,6,6,6,6,6,6,6,6,6,6,6,6,6,6,6,6,6,6,6,6,1,6,6,6,6,6,6,6,6,6,6,6,6,6,6,6,6,6,6,6,6,6,6
0.2431373,0.282353,0.6156863
0.4705883,0.5529412,0.7764707
0.5529412,0.6980392,0.7686275
0.7254902,0.8156863,0.8666667
0.854902,0.9058824,0.9333334
0.9333334,0.9960785,0.9882354
0.1294118,0.1529412,0.3490196
0.1529412,0.1843137,0.427451
0.6313726,0.1254902,0.1529412
0.6509804,0.07843138,0.07450981
0.9019608,0.1215686,0.1490196
0.9529412,0.5450981,0.1607843
0.9960785,0.7882354,0.2