1
3-5
False,0
False,0
39,69
-1,6,6,6,6,6,6,6,6,6,6,6,6,6,6,6,6,6,6,6,6,6,6,6,6,6,6,6,6,6,6,6,6,6,6,6,6,6,-1
6,6,2,2,2,2,2,2,2,2,2,2,2,2,2,2,2,2,2,2,2,2,2,2,2,2,2,2,2,2,2,2,2,2,2,2,2,6,6
6,2,2,3,3,3,3,3,3,3,3,3,3,3,3,3,3,3,3,3,3,3,3,3,3,3,3,3,3,3,3,3,3,3,3,3,2,2,6
6,2,3,3,3,3,3,3,3,3,3,3,3,3,3,3,3,3,3,3,3,3,3,3,3,3,3,3,3,3,3,3,3,3,3,3,3,2,6
6,2,5,5,5,5,5,5,5,5,5,5,5,5,5,5,5,5,5,5,5,5,5,5,5,5,5,5,5,5,5,5,5,5,5,5,5,2,6
6,2,5,5,5,5,5,5,5,5,5,5,5,5,5,5,5,5,5,5,5,5,5,5,5,5,5,5,5,5,5,5,5,5,5,5,5,2,6
6,2,5,5,5,5,5,5,5,5,5,5,5,5,5,5,5,5,5,5,5,5,5,5,5,5,5,5,5,5,5,5,5,5,5,5,5,2,6
6,2,5,5,5,5,5,5,5,5,5,5,5,5,5,5,5,5,5,5,5,5,5,5,5,5,5,5,5,5,5,5,5,5,5,5,5,2,6
6,2,5,5,5,5,5,5,5,5,5,5,5,5,5,5,5,5,5,5,5,5,5,5,5,5,5,5,5,5,5,5,5,5,5,5,5,2,6
6,2,5,5,5,5,5,5,5,5,5,5,5,5,5,5,5,5,5,5,5,5,5,5,5,5,5,5,5,5,5,5,5,5,5,5,5,2,6
6,2,5,5,5,5,5,5,5,5,5,5,5,5,5,5,5,5,5,5,5,5,5,5,5,5,5,5,5,5,5,5,5,5,5,5,5,2,6
6,2,5,5,5,5,5,5,5,5,5,5,5,5,5,5,5,5,5,5,5,5,5,5,5,5,5,5,5,5,5,5,5,5,5,5,5,2,6
6,2,5,5,5,5,5,5,5,5,5,5,5,5,5,7,7,7,7,7,7,7,7,5,5,5,5,5,5,5,5,5,5,5,5,5,5,2,6
6,2,5,5,5,5,5,5,5,5,5,5,5,5,5,7,0,0,0,0,0,0,7,5,5,5,5,5,5,5,5,5,5,5,5,5,5,2,6
6,2,5,5,5,5,5,5,5,5,5,5,5,5,5,7,0,0,0,0,6,0,7,5,5,5,5,5,5,5,5,5,5,5,5,5,5,2,6
6,2,5,5,5,5,5,5,5,5,5,5,5,5,5,7,0,0,6,0,0,0,7,5,5,5,5,5,5,5,5,5,5,5,5,5,5,2,6
6,2,5,5,5,5,5,5,5,5,5,5,5,5,5,7,0,0,0,0,0,0,7,5,5,5,5,5,5,5,5,5,5,5,5,5,5,2,6
6,2,5,5,5,5,5,5,5,5,5,5,5,5,5,7,0,6,0,0,6,0,7,5,5,5,5,5,5,5,5,5,5,5,5,5,5,2,6
6,2,5,5,5,5,5,5,5,5,5,5,5,5,5,7,0,0,0,0,0,0,7,5,5,5,5,5,5,5,5,5,5,5,5,5,5,2,6
6,2,5,5,5,5,5,5,5,5,5,5,5,5,5,7,7,7,9,9,7,7,7,5,5,5,5,5,5,5,5,5,5,5,5,5,5,2,6
6,2,5,5,5,5,5,5,5,5,5,5,5,5,5,5,7,5,9,9,5,7,5,5,5,5,5,5,5,5,5,5,5,5,5,5,5,2,6
6,2,5,5,5,5,5,5,5,5,5,5,5,5,5,5,5,5,5,5,5,5,5,5,5,5,5,5,5,5,5,5,5,5,5,5,5,2,6
6,2,5,5,5,5,5,5,5,5,5,5,5,5,5,5,5,5,5,5,5,5,5,5,5,5,5,5,5,5,5,5,5,5,5,5,5,2,6
6,2,5,5,5,5,5,5,5,5,5,5,5,5,5,5,5,5,5,5,5,5,5,5,5,5,5,5,5,5,5,5,5,5,5,5,5,2,6
6,2,5,5,5,5,5,5,5,4,4,4,4,4,5,5,5,5,5,5,5,5,5,5,5,5,5,5,5,5,5,4,4,5,5,5,5,2,6
6,2,5,5,5,5,5,5,5,11,11,11,11,11,4,4,5,5,5,5,5,5,5,5,5,5,5,5,5,5,5,6,6,5,5,5,5,2,6
6,2,5,5,5,5,5,5,5,11,11,11,11,11,11,4,4,5,5,5,5,5,5,5,5,5,5,5,5,5,5,6,6,5,5,5,5,2,6
6,2,5,5,5,5,5,5,5,11,11,11,6,11,11,11,11,5,5,5,5,5,5,5,5,5,5,5,5,5,5,6,6,5,5,5,5,2,6
6,2,5,5,5,5,5,5,5,11,11,11,11,11,11,11,11,5,5,5,5,5,5,5,5,5,5,5,5,5,5,6,6,5,5,5,5,2,6
6,2,5,5,5,5,5,5,5,11,6,11,11,6,11,6,11,5,5,5,5,5,5,5,5,5,5,5,5,5,5,6,6,5,5,5,5,2,6
6,2,5,5,5,5,5,5,5,11,11,11,11,11,11,11,11,5,5,5,5,5,5,5,5,5,5,5,5,5,5,6,6,5,5,5,5,2,6
6,2,5,5,5,5,5,5,5,11,11,11,6,11,6,11,11,5,5,5,5,5,5,5,5,5,5,5,5,5,5,6,6,5,5,5,5,2,6
6,2,5,5,5,5,5,5,5,5,5,11,11,11,11,11,11,5,5,5,5,5,5,5,5,5,5,5,5,5,5,8,8,5,5,5,5,2,6
6,2,5,5,5,5,5,5,5,5,5,5,5,11,11,11,11,5,5,5,5,5,5,5,5,5,5,5,5,5,5,5,5,5,5,5,5,2,6
6,2,5,5,5,5,5,5,5,5,5,5,5,5,5,5,5,5,5,5,5,5,5,5,5,5,5,5,5,5,5,5,5,5,5,5,5,2,6
6,2,5,5,5,5,5,5,5,5,5,5,5,5,5,5,5,5,5,5,5,5,5,5,5,5,5,5,5,5,5,5,5,5,5,5,5,2,6
6,2,5,5,5,5,5,5,5,5,5,5,5,5,5,5,5,5,5,5,5,5,5,5,5,5,5,5,5,5,5,5,5,5,5,5,5,2,6
6,2,5,5,5,5,5,5,5,5,5,5,5,5,5,5,5,5,5,5,5,5,5,5,5,5,5,5,5,5,5,5,5,5,5,5,5,2,6
6,1,5,5,5,5,5,5,5,5,5,5,5,5,5,5,5,5,5,5,5,5,5,5,5,5,5,5,5,5,5,5,5,5,5,5,5,1,6
6,6,1,1,1,1,1,1,1,1,1,1,1,1,1,1,1,1,1,1,1,1,1,1,1,1,1,1,1,1,1,1,1,1,1,1,1,6,6
6,6,6,6,6,6,6,6,6,6,6,6,6,6,6,6,6,6,6,6,6,6,6,6,6,6,6,6,6,6,6,6,6,6,6,6,6,6,6
6,6,2,2,2,2,2,2,2,2,2,2,2,2,2,2,2,2,2,2,2,2,2,2,2,2,2,2,2,2,2,2,2,2,2,2,2,6,6
6,2,2,3,3,3,3,3,3,3,3,3,3,3,3,3,3,3,3,3,3,3,3,3,3,3,3,3,3,3,3,3,3,3,3,3,2,2,6
6,2,5,5,5,5,5,5,5,5,5,5,5,5,5,5,5,5,5,5,5,5,5,5,5,5,5,5,5,5,5,5,5,5,5,5,5,2,6
6,2,5,5,5,5,5,5,5,5,5,5,5,5,5,5,5,5,5,5,5,5,5,5,5,5,5,5,5,5,5,5,5,5,5,5,5,2,6
6,2,5,5,5,5,5,5,5,5,5,5,5,5,5,5,5,5,5,5,5,5,5,5,5,5,5,5,5,5,5,5,5,5,5,5,5,2,6
6,2,5,5,5,5,5,5,5,5,5,5,5,5,5,5,5,5,5,5,5,5,5,5,5,5,5,5,5,5,5,5,5,5,5,5,5,2,6
6,2,5,5,5,5,5,5,5,5,5,5,5,5,5,5,5,5,5,5,5,5,5,5,5,5,5,5,5,5,5,5,5,5,5,5,5,2,6
6,2,5,5,5,5,5,5,5,5,5,5,5,5,5,5,5,5,5,5,5,5,5,5,5,5,5,5,5,5,5,5,5,5,5,5,5,2,6
6,2,5,5,5,5,5,5,5,5,5,5,5,5,5,5,5,5,5,5,5,5,5,5,5,5,5,5,5,5,5,4,4,5,5,5,5,2,6
6,2,5,5,5,5,5,5,5,5,5,5,5,5,5,5,5,5,5,5,5,5,5,5,5,5,5,5,5,5,5,6,6,5,5,5,5,2,6
6,2,5,5,5,5,5,5,4,5,4,5,4,5,5,5,5,5,5,5,5,5,5,5,5,5,5,5,5,5,5,6,6,5,5,5,5,2,6
6,2,5,5,5,5,7,4,7,4,7,4,7,4,7,5,5,5,5,5,5,5,5,5,5,5,5,5,5,5,5,6,6,5,5,5,5,2,6
6,2,5,5,5,5,7,7,0,7,0,7,0,7,7,5,5,5,5,5,5,5,5,5,5,5,5,5,5,5,5,6,6,5,5,5,5,2,6
6,2,5,5,5,5,7,0,0,0,0,0,0,0,7,5,5,5,5,5,5,5,5,5,5,5,5,5,5,5,5,6,6,5,5,5,5,2,6
6,2,5,5,5,5,7,0,10,10,10,10,10,0,7,5,5,5,5,5,5,5,5,5,5,5,5,5,5,5,5,6,6,5,5,5,5,2,6
6,2,5,5,5,5,7,0,10,10,10,10,10,0,7,5,5,5,5,5,5,5,5,5,5,5,5,5,5,5,5,8,8,5,5,5,5,2,6
6,2,5,5,5,5,7,0,10,10,10,10,10,0,7,5,5,5,5,5,5,5,5,5,5,5,5,5,5,5,5,5,5,5,5,5,5,2,6
6,2,5,5,5,5,7,0,10,10,10,10,10,0,7,5,5,5,5,5,5,5,5,5,5,5,5,5,5,5,5,5,5,5,5,5,5,2,6
6,2,5,5,5,5,7,0,0,0,0,0,0,0,7,5,5,5,5,5,5,5,5,5,5,5,5,5,5,5,5,5,5,5,5,5,5,2,6
6,2,5,5,5,5,7,7,7,9,9,9,7,7,7,5,5,5,5,5,5,5,5,5,5,5,5,5,5,5,5,5,5,5,5,5,5,2,6
6,2,5,5,5,5,5,5,5,9,9,9,5,5,5,5,5,5,5,5,5,5,5,5,5,5,5,5,5,5,5,5,5,5,5,5,5,2,6
6,2,5,5,5,5,5,5,5,5,5,5,5,5,5,5,5,5,5,5,5,5,5,5,5,5,5,5,5,5,5,5,5,5,5,5,5,2,6
6,2,5,5,5,5,5,5,5,5,5,5,5,5,5,5,5,5,5,5,5,5,5,5,5,5,5,5,5,5,5,5,5,5,5,5,5,2,6
6,2,5,5,5,5,5,5,5,5,5,5,5,5,5,5,5,5,5,5,5,5,5,5,5,5,5,5,5,5,5,5,5,5,5,5,5,2,6
6,2,5,5,5,5,5,5,5,5,5,5,5,5,5,5,5,5,5,5,5,5,5,5,5,5,5,5,5,5,5,5,5,5,5,5,5,2,6
6,1,1,1,1,1,1,1,1,1,1,1,1,1,1,1,1,1,1,1,1,1,1,1,1,1,1,1,1,1,1,1,1,1,1,1,1,1,6
6,6,1,1,1,1,1,1,1,1,1,1,1,1,1,1,1,1,1,1,1,1,1,1,1,1,1,1,1,1,1,1,1,1,1,1,1,6,6
-1,6,6,6,6,6,6,6,6,6,6,6,6,6,6,6,6,6,6,6,6,6,6,6,6,6,6,6,6,6,6,6,6,6,6,6,6,6,-1
1,0.9725491,0.9450981
0.9568628,0.9960785,0.8431373
0.4392157,0.8000001,0.682353
0.482353,0.9529412,0.7921569
0.3843138,0.7333333,0.8078432
0.3333333,0.8784314,1
0.3098039,0.07450981,0.05490196
0.3960785,0.01960784,0.01960784
0.5176471,0.1764706,0.1529412
0.9647059,0.2078432,0.2705882
1,0.3058824,0.1019608
0.9450981,0.9137256,0