1
61-1
False,0
False,0
60,81
0,0,17,17,7,0,0,0,0,0,0,0,0,18,18,0,0,0,0,0,2,2,2,2,2,2,2,2,0,0,0,0,0,0,0,2,5,11,7,11,11,11,11,11,11,11,11,11,11,8,9,9,9,9,9,9,9,9,9,9
0,17,17,17,17,0,0,0,0,0,0,0,0,0,0,0,0,0,0,2,2,2,2,2,2,2,2,2,2,2,2,2,2,2,2,2,5,11,7,11,11,11,11,11,11,11,11,9,9,9,9,9,9,9,9,9,9,9,9,9
17,17,17,17,17,0,0,0,0,0,0,0,0,0,0,0,2,2,2,2,2,2,2,2,2,2,2,2,2,2,2,2,2,2,2,5,11,11,7,11,11,11,11,11,8,9,9,9,9,9,9,9,9,9,9,9,9,9,9,9
17,16,16,17,17,0,0,0,0,0,2,2,2,2,2,2,2,2,2,2,2,2,2,2,2,2,2,2,2,2,2,2,2,2,2,5,11,11,7,11,11,8,8,9,9,9,9,9,9,9,9,9,9,9,9,9,9,9,9,9
17,16,16,17,0,0,0,0,0,0,6,6,6,6,6,6,6,6,6,6,6,6,6,6,6,6,6,6,6,6,6,6,6,6,6,5,8,7,7,11,0,0,0,0,9,9,9,9,9,9,9,9,9,9,9,9,9,9,9,9
16,16,17,17,0,0,0,0,0,0,2,2,2,2,2,2,2,2,2,2,2,2,2,2,2,2,2,2,2,2,2,2,2,2,2,5,8,7,7,0,1,1,1,0,0,0,9,9,9,9,9,9,9,9,9,9,9,9,9,9
17,17,7,0,0,0,0,0,0,0,2,2,2,2,2,2,2,2,2,2,2,2,2,2,2,2,2,2,2,2,2,2,2,2,5,8,8,7,0,1,1,16,16,16,1,1,0,9,9,9,9,9,9,9,9,9,9,9,9,9
17,0,7,0,0,0,0,0,0,0,2,2,2,2,2,2,2,2,2,2,2,2,2,2,2,2,2,2,2,2,2,2,2,2,5,8,9,7,7,1,1,16,16,1,0,0,0,9,9,9,9,9,9,9,9,9,9,9,9,9
0,0,7,0,0,0,0,0,0,2,2,2,2,2,2,2,2,2,2,2,2,2,2,2,2,2,2,2,2,2,2,2,2,2,5,9,9,7,7,9,0,0,0,0,0,9,9,9,9,9,9,9,9,9,9,9,9,9,9,9
0,0,7,0,0,0,0,0,2,2,2,2,2,2,2,2,2,2,2,2,2,2,2,2,2,2,2,2,2,2,2,2,2,2,5,9,9,9,7,9,9,0,0,9,9,9,9,9,9,9,9,9,9,9,9,9,9,9,9,9
0,0,7,0,0,0,0,2,2,2,2,2,2,2,2,2,2,2,2,2,2,2,2,2,2,2,2,2,2,2,2,2,2,2,5,9,9,7,7,9,9,9,9,9,9,9,9,9,9,9,9,9,9,9,9,9,9,9,9,9
0,0,7,0,0,0,2,2,2,2,2,2,2,2,2,2,2,2,2,2,2,2,2,2,2,2,2,2,2,2,2,2,2,2,5,9,9,7,9,9,9,9,9,9,9,9,9,9,9,9,9,9,9,9,9,9,9,9,9,9
0,2,7,2,2,2,2,2,2,2,2,2,2,2,2,2,2,2,2,2,2,2,2,2,2,2,2,2,2,2,2,2,2,5,9,9,7,7,9,9,9,9,9,9,9,9,9,9,9,9,9,9,9,9,9,9,9,9,9,9
0,0,7,2,2,2,2,2,2,2,2,2,2,2,2,2,2,2,2,2,2,2,2,2,2,2,2,2,2,2,2,2,4,5,9,7,7,9,9,9,9,9,9,9,9,9,9,9,9,9,9,9,9,9,9,9,9,9,9,9
0,0,7,2,2,2,2,2,2,2,2,2,2,2,2,2,2,2,2,2,2,2,2,2,2,2,2,2,2,2,4,4,4,5,9,7,7,9,9,18,18,9,9,9,9,9,9,9,9,9,9,9,9,9,9,9,9,9,9,9
10,0,7,2,2,2,2,2,2,2,2,2,2,2,2,2,2,2,2,2,2,2,2,2,2,2,2,2,4,4,4,4,4,5,9,9,7,18,18,18,18,18,18,18,9,9,9,9,9,9,9,9,9,9,9,9,9,9,9,9
12,0,7,2,2,2,2,2,2,2,2,2,2,2,2,2,2,2,2,2,2,2,2,2,2,2,4,4,4,4,4,4,5,9,9,9,7,18,18,16,16,18,18,18,9,9,9,9,9,9,9,9,9,9,9,9,9,9,9,9
10,0,7,7,2,2,2,7,7,7,2,2,2,2,2,2,2,2,2,2,2,2,2,2,2,4,4,4,4,4,4,4,5,9,9,9,7,18,16,16,16,18,18,18,9,9,9,9,9,9,9,9,9,9,9,9,9,9,9,9
0,0,2,7,2,2,7,15,15,15,7,2,2,2,4,4,4,4,4,4,4,4,4,4,4,4,4,4,4,4,4,4,5,9,9,9,7,18,16,16,16,18,18,9,9,9,9,9,9,9,9,9,9,9,9,9,9,9,9,9
0,2,2,7,2,7,15,15,15,16,16,7,2,4,4,4,4,4,4,4,4,4,4,4,4,4,4,4,4,4,4,4,5,9,9,7,7,18,18,18,18,9,9,9,9,9,9,9,9,9,9,9,9,9,9,9,9,9,9,9
2,7,7,7,7,15,15,15,16,16,16,7,7,7,7,7,7,7,7,7,7,4,4,4,4,4,4,4,4,4,4,4,5,9,9,7,9,9,9,9,9,9,9,9,9,9,9,9,9,9,9,9,9,9,9,9,9,9,9,9
7,7,15,15,15,15,15,16,16,16,16,7,14,16,16,16,16,16,16,16,7,7,5,5,5,5,5,17,17,5,5,5,9,9,7,7,9,9,9,9,9,9,9,9,9,9,9,9,9,9,9,9,9,9,9,9,9,9,9,9
15,15,15,15,15,15,15,16,16,16,16,7,14,16,16,16,16,16,16,16,16,16,7,9,9,9,9,17,17,9,9,9,9,7,7,9,9,9,9,9,9,9,9,9,9,9,9,9,9,9,9,9,9,9,9,9,9,9,9,9
15,15,16,16,16,16,16,16,16,16,16,7,14,15,16,16,16,16,16,16,16,16,7,9,9,9,9,17,17,9,9,9,7,7,9,9,9,9,9,9,9,9,9,9,9,9,9,9,9,9,9,15,9,9,9,9,9,9,9,9
15,15,16,16,16,16,16,16,16,16,7,14,15,15,15,15,16,16,16,16,16,16,7,9,9,9,9,9,17,17,9,7,7,9,9,9,9,9,9,9,9,9,9,9,9,9,9,9,9,9,9,9,9,9,9,9,9,9,9,9
15,15,15,15,7,7,7,7,7,7,14,15,15,7,7,16,16,16,16,16,16,16,7,9,9,9,9,9,17,17,7,7,9,9,9,9,9,19,19,19,9,9,9,9,9,9,9,9,9,9,9,9,9,9,9,9,9,9,9,9
15,15,15,16,16,14,14,14,14,14,15,15,7,7,7,16,16,16,16,16,16,16,7,9,9,9,9,9,3,17,7,9,9,9,9,17,19,19,19,19,19,19,9,9,9,9,9,9,9,9,9,9,9,9,9,9,9,9,9,9
15,15,15,16,16,16,16,16,16,15,16,16,7,7,14,16,16,16,16,16,16,16,7,9,9,9,7,7,7,17,19,9,9,9,9,17,19,19,19,19,19,19,9,9,9,9,9,9,9,9,9,9,9,9,9,9,9,9,9,9
15,15,15,16,16,16,16,16,16,16,16,16,7,14,14,16,16,16,16,16,16,16,7,7,9,7,7,9,9,19,19,9,9,9,9,17,17,19,19,19,19,19,9,9,9,9,9,9,9,9,9,9,9,9,9,9,9,9,9,9
15,15,15,15,16,16,16,16,16,16,16,15,7,14,14,16,16,16,16,16,16,16,7,7,7,7,9,9,9,3,19,9,9,9,9,9,17,19,19,19,19,19,9,9,9,9,9,9,9,9,9,9,9,9,9,9,9,9,9,9
15,15,15,15,15,15,16,16,16,16,16,7,7,14,14,16,16,16,16,16,16,7,9,7,7,7,7,9,9,9,19,9,9,9,9,9,17,19,19,19,19,19,19,19,19,19,9,9,9,9,9,9,9,9,9,9,9,9,9,9
7,15,15,15,15,15,15,15,15,15,7,9,7,14,14,16,16,16,16,16,16,7,7,7,9,9,7,7,7,3,19,9,9,17,17,17,9,17,19,19,19,19,19,19,19,19,19,9,9,9,9,9,9,9,9,9,9,9,9,9
9,7,7,15,15,15,15,15,7,7,9,9,9,7,14,16,16,16,16,16,16,7,7,9,9,9,9,9,7,7,3,9,9,17,17,17,17,9,19,19,19,19,19,19,19,19,19,9,9,9,9,9,9,9,9,9,9,9,9,9
9,9,9,7,7,7,7,7,9,9,9,9,9,7,15,16,16,16,16,16,7,9,7,9,9,9,9,9,9,7,9,17,17,17,17,17,17,17,19,19,19,19,19,19,19,19,19,9,9,9,9,9,9,9,9,9,9,9,9,9
9,9,9,9,9,9,9,9,9,9,9,9,9,7,15,15,16,16,16,16,7,9,7,7,9,9,9,9,9,7,9,9,9,17,17,17,17,17,17,17,19,19,19,19,19,19,19,9,9,9,9,9,9,9,9,9,9,9,9,9
9,9,9,9,9,9,9,9,9,9,9,9,9,9,7,7,15,16,16,7,19,19,9,7,7,9,9,9,7,7,10,10,10,9,17,17,17,17,9,17,19,19,19,19,19,19,19,9,9,9,9,9,9,9,9,9,9,9,9,9
9,9,9,9,9,9,9,9,9,9,9,9,9,9,9,3,7,7,7,19,19,19,9,9,7,7,7,7,7,13,16,13,10,10,9,17,17,8,8,17,19,19,8,9,9,9,9,9,9,9,9,9,9,9,9,9,9,9,9,9
9,9,9,9,9,9,9,9,9,9,9,3,3,3,3,3,19,19,19,19,19,19,9,9,9,9,3,19,19,13,16,16,16,13,8,17,17,8,8,17,19,19,19,9,9,9,9,9,9,9,9,9,9,9,9,9,9,9,9,8
9,9,9,9,9,9,9,9,9,9,3,3,3,3,3,3,3,19,19,19,19,8,8,3,3,19,17,17,8,10,13,13,16,16,10,8,8,8,17,19,19,19,19,19,8,9,9,9,9,9,9,9,9,9,9,9,9,8,8,8
9,9,9,9,9,9,9,9,9,9,9,3,3,3,3,3,3,3,3,3,3,3,3,19,17,8,8,8,8,8,10,10,13,16,13,8,8,8,17,19,19,19,19,19,8,8,8,9,9,9,9,9,9,9,8,8,8,8,8,8
8,8,8,8,8,8,8,8,8,8,8,8,8,8,3,3,3,3,3,19,19,19,19,17,8,8,8,8,8,8,8,8,10,10,13,8,8,8,17,19,19,19,19,19,8,8,8,8,8,8,8,8,8,8,8,8,8,8,8,8
8,8,8,8,8,8,8,8,8,8,8,8,8,8,8,8,8,3,19,19,19,19,17,8,8,8,8,8,8,8,8,8,8,8,8,8,8,8,8,19,19,19,19,19,8,8,8,8,8,8,8,8,8,8,8,8,8,8,8,8
8,8,8,8,8,8,8,8,8,8,8,8,8,8,8,8,19,19,19,17,17,17,17,17,8,8,8,8,8,8,8,8,8,8,8,8,8,8,8,8,8,8,8,8,8,8,8,8,8,8,8,8,8,8,8,8,8,8,8,8
8,8,8,8,8,8,8,8,8,8,8,8,8,8,19,19,19,19,17,17,17,17,17,17,17,8,8,8,8,8,8,8,8,8,8,8,8,8,8,8,8,8,8,8,8,8,8,8,8,8,8,8,8,8,8,8,8,8,8,8
8,8,8,8,8,8,8,8,8,8,8,8,8,19,19,19,19,17,17,17,17,17,17,17,8,8,8,8,8,8,8,8,8,8,8,8,8,8,8,8,8,8,8,8,8,8,8,8,8,8,8,8,8,8,8,8,8,8,8,8
8,8,8,8,8,8,8,8,8,8,8,8,19,19,19,19,17,8,8,17,17,17,8,8,8,8,8,8,8,8,8,8,8,8,8,8,8,8,8,8,8,8,8,8,8,8,8,8,8,8,8,8,8,8,8,8,8,8,8,8
8,8,8,8,8,8,8,8,8,8,8,8,19,19,17,17,8,8,8,8,8,8,8,8,8,8,8,8,8,8,8,8,8,8,8,8,8,8,8,8,8,8,8,8,8,8,8,8,8,8,8,8,8,8,8,8,8,8,8,8
8,8,8,8,8,8,8,8,8,8,8,8,19,17,8,8,8,8,8,8,8,8,8,8,8,8,8,8,8,8,8,8,8,8,8,8,8,8,8,8,8,8,8,8,8,8,8,8,8,8,8,8,8,8,8,8,8,8,8,8
8,8,8,8,8,8,8,8,8,8,8,8,8,8,8,8,8,8,8,8,8,8,8,8,8,8,8,8,8,8,8,8,8,8,8,8,8,8,8,8,8,8,8,8,8,8,8,8,8,8,8,8,8,8,8,8,8,8,8,8
8,8,8,8,8,8,8,8,8,8,8,8,8,8,8,8,8,8,8,8,8,8,8,8,8,8,8,8,8,8,8,8,8,8,8,8,8,8,8,8,8,8,8,8,8,8,8,8,8,8,8,8,8,8,8,8,8,8,8,8
8,8,8,8,8,8,8,8,8,8,8,8,8,8,8,8,8,8,8,8,8,8,8,8,8,8,8,8,8,8,8,8,8,8,8,8,8,8,8,8,8,8,8,8,8,8,8,8,8,8,8,8,8,8,8,8,8,8,8,8
8,8,8,8,8,8,8,8,8,8,8,8,8,8,8,8,8,8,8,8,8,8,8,8,8,8,8,8,8,8,8,8,8,8,8,8,8,8,8,8,8,8,8,8,8,8,8,8,8,8,8,8,8,8,15,8,8,8,8,8
8,8,8,8,8,8,8,8,8,8,8,8,8,8,8,8,8,8,8,8,8,8,8,8,8,8,8,8,8,8,8,8,8,8,8,8,8,8,8,8,8,8,8,8,8,8,8,8,8,8,8,8,8,8,8,8,8,8,8,8
8,8,8,8,8,8,8,8,8,8,8,8,8,8,8,8,8,8,8,8,8,8,8,8,8,8,8,8,8,8,8,8,8,8,8,8,8,8,8,8,8,8,8,8,8,8,8,8,8,8,8,8,8,8,8,8,8,8,8,8
8,8,8,8,8,8,8,8,8,8,8,8,8,8,8,8,8,8,8,8,8,8,8,8,8,8,8,8,8,8,8,8,8,8,8,8,8,8,8,8,8,8,8,8,8,8,8,8,8,8,8,8,8,8,8,8,8,8,8,8
8,8,8,8,8,8,8,8,8,8,8,8,8,8,8,8,8,8,8,8,8,8,8,8,8,8,8,8,8,8,8,8,8,8,8,8,8,8,8,8,8,15,8,8,8,8,8,8,8,8,8,8,8,8,8,8,8,8,8,8
8,8,8,8,8,8,8,8,8,8,8,8,8,8,8,8,8,8,8,8,8,8,8,8,8,8,8,8,8,8,8,8,8,8,8,8,8,8,8,8,8,8,8,8,8,8,8,8,8,8,8,8,8,8,8,8,8,8,8,8
8,8,8,8,8,8,8,8,8,8,8,8,8,8,8,8,8,8,8,8,8,8,8,8,8,8,8,8,8,8,8,8,8,8,8,8,8,8,8,8,8,8,8,8,8,8,8,8,8,8,8,8,8,8,8,8,8,8,8,8
8,8,8,8,8,8,8,8,8,8,8,8,8,8,8,8,8,8,8,8,8,8,8,8,8,8,8,8,8,8,8,8,8,8,8,8,8,8,8,8,8,8,8,8,8,8,8,8,8,8,8,8,8,8,8,8,8,8,8,8
8,8,8,8,8,8,8,8,8,8,8,8,8,8,8,8,8,8,8,8,8,8,8,8,8,8,8,8,8,8,8,8,8,8,8,8,8,8,8,8,8,8,8,8,8,8,8,8,8,8,8,8,8,8,8,8,8,8,8,8
8,8,8,8,7,7,7,7,7,7,7,7,7,7,7,7,7,7,7,7,7,8,8,8,8,8,8,8,8,8,8,8,8,8,8,8,8,8,8,8,8,8,8,8,8,8,8,8,8,8,8,8,8,8,8,8,8,8,8,8
7,7,7,7,7,7,7,7,7,7,7,7,7,7,7,7,7,7,7,7,7,7,7,7,7,7,8,8,8,8,8,8,8,8,8,8,8,8,8,8,8,8,8,8,8,8,8,8,8,8,8,8,8,8,8,8,8,8,8,8
7,7,7,7,7,7,7,7,7,7,7,7,7,7,7,7,7,7,7,7,7,7,7,7,7,7,7,7,7,7,7,7,8,8,8,8,8,8,8,8,8,8,8,8,8,8,8,8,8,8,8,8,8,8,8,8,8,8,8,8
7,7,7,7,7,7,7,7,7,7,7,7,7,7,7,7,7,7,7,7,7,7,7,7,7,7,7,7,7,7,7,7,7,7,7,7,7,7,7,7,7,8,8,8,8,8,8,8,8,8,8,8,8,8,8,8,8,8,8,8
7,7,7,7,7,7,7,7,7,7,7,7,7,7,7,7,7,7,7,7,7,7,7,7,7,7,7,7,7,7,7,7,7,7,7,7,7,7,7,7,7,7,7,8,8,8,8,8,8,8,8,8,8,8,8,8,8,8,8,8
7,7,7,7,7,7,7,7,7,7,7,7,7,7,7,7,7,7,7,7,7,7,7,7,7,7,7,7,7,7,7,7,7,7,7,7,7,7,7,7,7,7,7,7,7,7,7,7,7,7,8,8,8,8,8,8,8,8,8,8
7,7,7,7,7,7,7,7,7,7,7,7,7,7,7,7,7,7,7,7,7,7,7,7,7,7,7,7,7,7,7,7,7,7,7,7,7,7,7,7,7,7,7,7,7,7,7,7,7,7,7,7,7,7,7,7,7,7,7,8
7,7,7,7,7,7,7,7,7,7,7,7,7,7,7,7,7,7,7,7,7,7,7,7,7,7,7,7,7,7,7,7,7,7,7,7,7,7,15,7,7,7,7,7,7,7,7,7,7,7,7,7,7,7,7,7,7,7,7,7
7,7,7,7,7,7,7,7,7,7,7,7,7,7,7,7,7,7,7,7,7,7,7,7,7,7,7,7,7,7,7,7,7,7,7,7,7,7,15,7,7,7,7,7,7,7,7,7,7,7,7,7,7,7,7,7,7,7,7,7
7,7,7,7,7,7,7,7,7,7,7,7,7,7,7,7,7,7,7,7,7,7,7,7,7,7,7,7,7,7,7,7,7,7,7,7,7,7,7,7,7,7,7,7,7,7,7,7,7,7,7,7,7,7,7,7,7,7,7,7
7,7,7,7,7,7,7,7,7,7,7,7,7,7,7,7,7,7,7,7,7,7,7,7,7,7,7,7,7,7,7,7,7,7,7,7,7,7,7,7,7,7,7,7,7,7,7,7,7,7,7,7,7,7,7,7,7,7,7,7
7,7,7,7,7,7,7,7,7,7,7,7,7,7,7,7,7,7,7,7,7,7,7,7,7,7,7,7,7,7,7,7,7,7,7,7,7,7,7,7,7,7,7,7,7,7,7,7,7,7,7,7,7,7,7,7,7,7,7,7
7,7,7,7,7,7,7,7,7,7,7,7,7,7,7,7,7,7,7,7,7,7,7,7,7,7,7,7,7,7,7,7,7,7,7,7,7,7,7,7,7,7,7,7,7,7,7,7,7,7,7,7,7,7,7,7,7,7,7,7
7,7,7,7,7,7,7,7,7,7,7,7,7,7,7,7,7,7,7,7,7,7,7,7,7,7,7,7,7,7,7,7,7,7,7,7,7,7,7,7,7,7,7,7,7,7,7,7,7,7,7,7,7,7,7,7,7,7,7,7
7,7,7,7,7,7,7,7,7,7,7,7,7,7,7,7,7,7,7,7,7,7,7,7,7,7,7,7,7,7,7,7,7,7,7,7,7,7,7,7,7,7,7,7,7,7,7,7,7,7,7,7,7,7,7,7,7,7,7,7
7,7,7,7,7,7,7,7,7,7,7,7,7,7,7,7,7,7,7,7,7,7,7,7,7,7,7,7,7,7,7,7,7,7,7,7,7,7,7,7,7,7,7,7,7,7,7,7,7,7,7,7,7,7,7,7,7,7,7,7
7,7,7,7,7,7,7,7,7,7,7,7,7,7,7,7,7,7,7,7,7,7,7,7,7,7,7,7,7,7,7,7,7,7,7,7,7,7,7,7,7,7,7,7,7,7,7,7,7,7,7,7,7,7,7,7,7,7,7,7
7,7,7,7,7,7,7,7,7,7,7,7,7,7,7,7,7,7,7,7,7,7,7,7,7,7,7,7,7,7,7,7,7,7,7,7,7,7,7,7,7,7,7,7,7,7,7,7,7,7,7,7,7,7,7,7,7,7,7,7
7,7,7,7,7,7,7,7,7,7,7,7,7,7,7,7,7,7,7,7,7,7,7,7,7,7,7,7,7,7,7,7,7,7,7,7,7,7,7,7,7,7,7,7,7,7,7,7,7,7,7,7,7,7,7,7,7,7,7,7
7,7,7,7,7,7,7,7,7,7,7,7,7,7,7,7,7,7,7,7,7,7,7,7,7,7,7,7,7,7,7,7,7,7,7,7,7,7,7,7,7,7,7,7,7,7,7,7,7,7,7,7,7,7,7,7,7,7,7,7
7,7,7,7,7,7,7,7,7,7,7,7,7,7,7,7,7,7,7,7,7,7,7,7,7,7,7,7,7,7,7,7,7,7,7,7,7,7,7,7,7,7,7,7,7,7,7,7,7,7,7,7,7,7,7,7,7,7,7,7
1,0.1921569,0.2039216
1,0.3529412,0.4901961
0.8431373,0.1529412,0.1803922
0.6980392,0.2078432,0
0.5803922,0.1098039,0.145098
0.482353,0,0
0.4431373,0,0
0.05882353,0.08235294,0.1607843
0.06666667,0.09803922,0.3058824
0.09411766,0.1294118,0.3843138
0.06666667,0.2431373,0.627451
0.3647059,0.3803922,0.7803922
0.4901961,0.4784314,0.9058824
0.4,0.4745098,1
0.8588236,0.7176471,1
0.9137256,0.8470589,0.9568628
1,1,0.8431373
1,0.9294118,0.2745098
0.2235294,0.9450981,0.1960784
0.9803922,0.5411765,0.07843138