1
52-2
False,0
False,0
60,54
0,0,0,0,0,0,0,0,0,0,0,0,8,5,6,6,6,6,6,6,6,7,9,11,5,11,11,11,11,0,0,0,0,0,0,0,0,23,1,1,14,14,23,19,14,11,19,11,2,2,5,5,22,22,5,5,5,5,5,5
0,0,0,0,0,0,0,0,0,0,0,0,23,6,6,6,6,6,6,6,7,7,9,11,5,5,11,0,0,0,0,0,0,0,0,0,11,0,23,1,14,14,23,19,14,11,19,11,18,2,5,5,5,5,5,5,5,5,5,5
0,0,0,0,0,0,0,0,0,0,0,8,6,6,6,6,6,6,6,6,7,7,9,0,11,11,11,0,0,0,0,0,0,0,11,11,23,11,11,23,1,14,14,23,14,11,19,11,18,18,4,4,4,4,4,4,4,4,5,5
0,0,0,0,0,0,0,0,0,0,23,6,6,6,6,6,6,6,6,6,7,9,0,0,0,0,0,0,0,0,0,0,12,12,0,0,23,0,11,23,1,1,17,14,11,11,11,15,18,18,2,4,4,4,4,4,4,2,2,4
0,0,0,0,0,0,0,0,0,0,23,6,6,6,6,6,6,7,7,7,7,9,0,0,0,11,0,0,0,0,0,12,12,0,0,0,23,0,0,11,23,1,1,11,1,18,18,11,18,18,18,2,2,2,4,4,4,2,2,4
0,0,0,0,0,0,0,0,0,0,23,5,5,6,6,6,6,6,6,7,7,7,9,0,0,0,0,11,0,0,12,12,0,0,0,0,23,0,0,0,11,23,11,1,1,18,18,11,1,11,11,18,18,18,2,2,2,2,2,2
0,0,19,19,19,19,19,19,19,19,23,5,5,6,5,6,6,6,6,6,7,7,9,0,0,0,0,0,11,0,12,0,0,0,0,0,23,0,0,0,0,11,11,1,1,18,18,11,1,1,19,11,11,18,15,18,18,18,2,2
0,0,0,20,20,20,20,20,20,20,23,5,5,6,5,5,6,6,6,6,6,7,9,0,0,0,0,0,0,11,12,0,0,0,0,0,23,0,0,0,0,11,19,11,11,18,18,11,1,1,19,19,18,11,11,11,11,18,18,2
0,0,0,0,0,0,0,0,0,0,23,5,5,8,5,5,6,6,6,6,6,7,9,19,19,19,0,0,0,13,11,0,0,0,0,0,23,0,0,0,0,14,11,11,19,11,11,11,1,1,19,19,11,12,11,19,19,11,11,18
0,0,0,0,0,0,0,0,0,0,23,5,5,8,5,5,5,6,6,6,6,7,7,20,19,19,19,19,12,13,0,11,0,0,0,0,0,23,0,0,0,14,11,19,19,11,19,1,1,1,19,23,12,12,11,19,19,19,19,11
0,0,0,0,0,0,0,0,0,0,23,5,5,8,5,5,5,6,6,6,6,7,7,9,20,20,20,20,13,0,0,0,11,0,0,0,0,11,23,0,0,14,11,19,19,11,18,11,11,1,19,23,12,11,19,19,19,19,19,23
0,0,0,0,0,0,0,0,0,0,23,5,5,5,8,5,5,6,6,6,6,7,7,7,0,0,0,0,13,20,20,0,0,11,0,0,0,0,23,0,0,14,11,19,19,11,19,11,5,11,18,23,12,11,19,19,19,19,19,23
0,0,0,0,0,0,0,0,0,0,23,5,5,5,8,5,5,6,6,6,6,7,7,7,9,0,0,13,0,20,20,20,20,11,0,0,0,0,23,23,0,11,11,19,19,11,19,18,11,5,5,23,12,11,19,19,19,19,19,19
0,0,0,0,0,0,19,19,19,19,23,5,5,5,5,8,5,6,6,6,6,6,7,7,9,0,0,13,0,0,0,20,20,20,11,0,0,0,0,23,23,14,11,19,19,18,1,18,11,5,5,23,12,11,18,18,18,19,19,19
0,0,0,0,0,0,0,19,0,0,23,5,5,5,6,6,8,5,6,6,6,6,7,7,7,9,0,13,19,19,0,0,20,20,11,14,0,0,0,0,23,14,11,19,19,18,1,18,18,11,5,23,12,11,18,18,18,18,18,19
19,19,19,19,19,19,19,19,19,19,23,5,5,5,6,7,7,8,5,6,6,6,9,7,7,9,13,13,0,19,19,19,19,19,20,11,19,19,19,19,23,14,14,11,19,18,1,1,18,11,5,23,13,13,11,18,18,18,18,18
0,0,19,19,19,0,0,0,0,0,23,5,5,6,7,7,7,8,5,6,6,9,8,7,7,9,23,0,0,0,0,0,19,19,20,11,14,19,19,23,14,14,14,11,19,18,1,1,18,14,5,23,13,13,11,18,18,18,18,18
19,19,19,19,19,19,0,0,0,0,23,5,5,7,7,7,7,8,5,6,6,9,7,7,7,9,13,23,19,19,19,0,0,19,19,11,11,19,19,23,14,14,14,11,19,18,19,1,18,18,14,23,13,13,11,18,18,18,18,18
19,19,19,19,19,19,19,19,19,19,19,8,6,9,7,9,9,8,5,6,9,7,7,7,7,9,13,19,23,19,19,19,19,19,19,19,11,14,19,23,14,14,14,11,19,18,19,1,18,18,14,14,23,13,11,16,17,18,19,19
2,2,2,2,2,2,2,2,2,22,2,8,6,6,8,6,6,8,5,6,9,7,7,7,7,9,13,19,19,23,19,19,19,19,19,19,11,14,19,23,14,11,11,11,11,11,11,11,18,18,18,14,23,13,12,11,11,17,18,18
2,2,2,2,2,2,2,2,2,2,9,5,8,6,8,6,6,8,5,6,9,7,7,7,7,9,13,14,14,23,14,14,14,14,14,14,11,14,14,23,11,11,14,14,14,18,19,1,1,18,18,14,14,23,13,11,9,11,17,18
3,3,3,3,3,3,3,3,3,3,9,5,6,8,8,6,6,8,5,6,9,7,8,7,7,9,12,14,14,12,23,14,14,14,14,14,11,14,11,11,14,14,14,14,14,11,18,1,1,1,18,14,14,23,13,11,9,6,11,17
3,3,3,3,3,3,3,19,19,19,19,9,6,8,8,7,6,8,5,6,9,7,9,7,7,9,12,14,14,14,23,14,14,14,14,14,11,11,11,14,14,14,14,14,11,11,11,11,1,1,18,14,14,23,12,12,11,9,6,11
3,3,3,3,3,19,19,19,19,19,19,19,9,5,6,8,7,8,5,6,9,9,7,7,9,12,12,19,19,19,23,12,14,14,14,11,11,11,11,14,14,14,11,11,12,12,12,12,11,11,18,18,14,14,23,12,11,9,6,6
3,3,3,3,3,19,19,19,19,19,19,19,9,7,7,7,7,8,5,6,9,11,11,11,11,11,11,11,19,19,19,23,14,14,14,11,12,13,14,14,14,11,11,13,13,12,12,11,13,13,11,18,14,14,14,23,12,11,9,6
3,3,3,3,3,19,19,19,19,19,11,11,11,11,15,15,15,15,5,6,9,15,15,15,15,11,11,19,19,19,19,23,14,14,14,23,11,13,14,14,11,11,13,13,12,12,13,11,11,11,11,11,18,14,14,23,12,13,11,6
3,3,3,3,19,11,11,11,11,11,15,15,15,15,15,15,15,15,15,6,11,11,15,15,19,23,12,19,19,19,19,23,12,19,23,11,14,13,14,14,11,13,13,12,12,13,11,11,11,11,11,13,11,14,14,14,23,12,11,9
3,3,19,19,18,11,15,15,15,15,15,18,18,18,18,18,11,11,15,15,6,6,9,19,19,23,12,19,19,19,19,23,12,23,11,14,14,13,14,11,12,13,13,12,13,12,11,11,11,11,13,11,11,11,11,14,8,23,12,11
19,19,19,19,19,11,18,18,18,18,18,18,11,11,11,11,16,16,16,5,6,9,19,19,19,23,12,19,19,19,19,23,11,23,14,14,14,13,11,11,13,13,13,13,13,12,11,11,11,11,13,11,11,11,11,11,8,5,23,12
19,19,19,19,19,21,18,18,18,18,11,11,23,5,5,5,8,19,23,5,23,19,19,19,19,23,11,19,19,19,19,19,23,11,19,19,11,13,11,11,13,13,13,13,12,11,11,11,11,11,11,11,11,11,11,11,5,6,6,23
19,19,19,19,19,21,21,21,21,21,19,19,19,23,23,23,19,19,19,23,19,19,19,19,19,23,13,11,19,11,19,19,23,11,19,19,11,12,11,13,13,13,13,11,11,11,11,11,11,11,13,11,11,11,11,8,7,6,6,6
18,18,18,18,18,18,18,18,18,18,18,18,18,18,18,19,19,19,19,19,19,19,19,19,19,23,13,11,19,19,19,23,11,11,19,11,11,12,11,13,13,11,13,11,12,11,11,11,11,11,13,11,11,11,11,9,9,7,7,7
18,18,18,18,18,18,18,18,18,18,18,18,18,19,19,19,19,19,19,19,19,19,19,19,19,23,13,11,19,19,19,23,11,11,19,11,19,12,11,13,11,13,12,11,12,11,11,11,11,23,8,8,8,8,8,8,9,9,7,7
18,18,18,18,18,18,18,18,18,18,18,18,18,19,19,19,19,19,19,19,19,19,19,19,19,23,13,11,19,19,19,23,19,11,11,11,19,12,11,13,11,13,12,11,12,11,11,11,23,5,6,6,6,6,6,6,6,8,9,9
18,18,18,18,18,18,18,18,18,19,19,19,19,19,19,19,19,19,19,19,19,19,19,19,19,23,13,13,11,19,23,11,19,12,11,11,19,12,11,12,11,13,11,11,12,11,11,23,5,6,6,6,6,6,6,6,6,6,8,8
18,18,18,18,18,18,18,19,19,19,19,19,19,19,19,19,19,19,19,19,19,19,19,19,19,23,13,12,11,19,23,11,19,12,11,11,19,12,11,12,11,13,11,11,12,11,23,5,6,6,6,6,6,6,6,6,6,6,6,6
18,18,18,18,18,18,18,18,18,18,18,18,18,19,19,19,19,19,19,19,19,19,19,19,19,19,23,13,11,19,23,11,19,12,11,11,19,12,11,12,11,13,11,11,12,23,5,6,6,6,6,6,6,6,6,6,6,6,6,6
18,18,18,18,18,18,18,18,18,18,18,18,18,18,18,3,3,3,3,3,3,3,3,3,3,22,23,13,11,18,23,11,19,12,11,11,19,12,11,12,13,12,11,11,23,5,6,6,6,6,8,8,6,6,6,6,6,6,6,6
18,18,18,18,18,18,18,18,18,18,18,18,18,18,18,3,3,3,3,3,3,3,3,3,3,3,23,12,12,11,11,11,19,12,11,11,19,12,11,12,13,12,11,23,5,6,6,6,6,6,6,6,6,6,6,6,6,6,6,6
18,18,18,18,18,18,18,18,18,18,18,18,18,18,18,18,18,18,3,3,3,3,3,3,3,3,3,23,12,11,11,11,19,12,11,11,19,12,11,12,11,12,23,5,6,6,6,6,6,6,6,6,6,6,6,6,6,6,6,6
18,18,18,18,18,18,18,18,18,18,18,18,18,18,18,18,18,18,18,18,3,3,3,3,3,3,3,23,12,11,11,11,19,12,11,11,19,12,11,12,11,23,6,6,6,6,6,6,6,9,9,9,9,7,6,6,6,6,6,6
18,18,18,18,18,18,18,18,18,18,18,18,18,18,18,18,18,18,18,18,3,3,3,3,3,3,3,23,12,12,11,11,18,12,11,11,19,12,11,11,23,5,6,6,6,6,6,6,10,10,10,10,10,9,6,6,6,6,6,6
18,18,18,18,18,18,18,18,18,18,18,18,18,18,18,18,18,18,18,18,3,3,3,3,3,3,11,11,23,12,11,11,3,12,11,11,11,11,11,12,5,6,6,6,6,6,6,9,10,10,10,10,10,10,9,6,6,6,6,6
18,18,18,18,18,18,18,18,18,18,18,18,18,18,18,18,18,18,18,18,3,3,3,3,3,23,11,11,3,12,11,11,3,11,11,11,11,11,11,23,6,6,6,6,6,6,9,9,5,5,5,5,5,10,8,6,6,6,6,6
18,18,18,18,18,18,18,18,18,18,18,18,18,18,18,18,18,18,18,18,18,3,3,3,3,23,12,11,3,23,11,11,11,11,11,11,12,12,11,23,6,6,6,6,6,6,6,6,6,6,6,6,6,6,6,6,6,6,6,6
18,18,18,18,18,18,18,18,18,18,18,18,18,18,18,18,18,18,18,18,3,3,19,3,3,23,12,11,3,11,11,11,11,11,12,12,11,11,23,6,6,6,6,6,6,6,6,6,6,6,6,6,6,6,6,6,6,6,6,6
18,18,18,18,18,18,18,18,18,18,18,18,18,18,18,18,18,18,18,18,18,18,18,18,23,12,11,3,3,3,11,12,12,12,11,11,11,11,5,7,7,7,7,7,7,6,6,6,6,6,6,6,6,6,6,6,6,6,7,7
18,18,18,18,18,18,18,18,18,18,18,18,18,18,18,18,18,18,18,18,18,18,18,18,23,12,11,3,3,3,11,12,12,11,11,11,14,23,8,7,8,7,8,7,7,7,6,6,6,6,6,6,6,6,6,6,8,7,7,8
19,19,19,19,19,18,18,18,18,18,18,18,18,18,20,20,18,18,18,18,18,18,18,18,23,12,11,3,3,11,11,12,11,11,11,14,11,23,5,8,7,8,7,8,7,7,7,6,9,8,6,6,6,6,6,7,7,8,7,7
19,19,19,19,19,19,19,19,19,19,19,19,18,18,20,20,20,18,18,18,18,18,18,18,23,12,11,18,18,11,12,11,11,11,11,14,11,23,5,7,8,7,8,7,7,7,7,6,23,8,6,6,6,6,6,7,7,7,8,7
19,19,19,19,19,19,19,19,19,19,19,19,19,19,20,20,20,19,19,19,19,19,18,18,23,12,11,18,18,11,12,11,11,11,14,14,11,23,5,7,5,7,7,7,7,7,6,6,5,5,6,6,6,6,6,6,7,7,7,7
2,2,2,2,2,2,2,2,2,2,2,2,2,2,20,20,20,2,2,2,18,18,18,18,23,12,11,18,18,11,12,11,11,11,14,11,11,23,5,7,7,7,7,7,7,6,6,6,5,5,5,6,6,6,6,6,6,8,15,9
3,3,3,2,2,2,2,18,18,18,18,18,18,18,18,20,20,18,18,18,18,18,18,18,23,13,11,18,11,11,12,11,6,23,14,11,11,23,5,8,15,8,15,8,8,6,6,6,6,6,6,6,6,6,6,6,6,5,5,5
3,3,3,18,18,18,18,18,18,18,18,18,18,18,18,20,18,18,18,18,18,18,18,18,23,13,11,18,11,12,11,11,11,23,14,11,11,23,5,5,5,5,5,5,5,5,6,6,6,6,6,6,6,6,6,6,23,5,5,14
0.2980392,0.8235295,0.937255
0.5803922,0.8156863,1
0.7072325,0.8719384,1
0.882353,0.9490197,1
0.909804,0.9529412,0.9607844
1,0.9810876,0.95461
1,0.917565,0.917565
1,0.8559715,0.8821746
1,0.7372549,0.7607844
0.9294118,0.5333334,0.509804
1,0.5254902,0.6470588
0.1985618,0.3197375,0.4759841
0.3803922,0.4862745,0.5215687
0.5607843,0.6745098,0.7137255
0.3058824,0.4941177,0.7294118
0.2235294,0.313852,0.7137255
0.4941177,0.6470588,0.9529412
0.4745098,0.5450981,0.9450981
0.3803922,0.6078432,1
0.3803922,0.7294118,1
0.7333333,1,0.9450981
0.4078432,1,0.882353
0.9803922,1,0.8745099
0.9766225,0.9255916,0.7567617