1
52-4
False,0
False,0
60,54
0,0,0,0,0,0,0,0,0,0,22,20,0,0,0,22,0,0,0,20,20,20,20,20,1,10,10,10,10,10,10,10,10,10,10,10,10,10,10,10,10,10,10,10,10,10,10,10,10,7,1,1,1,1,1,1,18,11,11,0
0,0,0,0,0,0,0,0,0,0,22,20,0,0,0,22,0,0,0,20,20,20,20,20,1,0,0,10,10,10,10,10,10,10,10,10,10,10,10,10,10,10,10,10,10,10,10,10,10,7,1,1,22,1,1,18,0,11,11,0
0,0,0,0,0,0,0,0,0,0,1,0,0,0,0,0,0,0,20,0,0,0,0,20,20,1,0,0,0,0,0,10,10,10,10,10,10,10,10,10,10,10,10,10,10,10,10,10,10,7,1,1,1,1,1,18,11,11,0,0
23,23,0,0,0,0,0,0,0,0,1,0,0,0,0,0,0,0,0,0,0,0,0,0,20,1,0,0,0,0,0,0,0,0,0,10,10,10,10,10,10,10,10,10,10,10,10,10,10,7,1,1,1,1,18,11,11,0,0,0
23,23,23,23,23,0,0,0,0,0,1,0,0,0,22,0,0,0,0,0,0,0,0,0,20,1,0,0,0,0,0,0,0,0,0,0,0,0,10,10,10,10,10,10,10,10,10,10,10,7,1,1,1,1,18,11,11,0,0,11
23,23,23,23,23,23,23,23,23,23,1,0,0,0,22,22,0,0,0,0,0,1,0,20,20,1,0,0,0,0,0,0,0,0,0,0,0,0,0,0,0,0,10,10,10,10,10,10,7,1,1,1,1,18,11,11,0,0,0,11
23,23,23,23,23,23,23,23,23,23,22,22,23,0,0,0,0,0,0,0,0,1,0,20,1,1,0,0,0,0,0,0,0,0,0,0,0,0,5,5,5,5,0,0,0,0,10,10,7,1,1,1,1,18,11,11,0,0,11,11
23,23,23,23,23,23,23,23,23,23,23,22,22,23,23,22,22,22,0,0,0,22,1,20,1,1,0,0,0,0,0,0,0,0,0,0,2,5,4,4,4,4,5,0,0,0,0,0,7,1,1,1,18,11,11,0,0,11,11,11
23,23,23,23,23,23,23,23,23,23,23,1,22,22,23,23,22,22,23,23,0,22,20,20,1,0,0,0,0,0,0,0,0,0,0,1,5,1,1,3,3,4,4,5,0,0,0,0,7,1,1,1,18,11,11,0,0,11,11,11
23,23,23,23,23,23,23,23,23,23,23,23,1,22,23,23,23,23,23,20,20,20,1,1,0,0,0,0,0,0,0,0,0,0,0,5,1,1,3,3,3,3,4,4,5,0,0,0,7,1,1,18,11,11,0,0,11,11,11,11
23,23,23,23,23,23,23,23,23,23,23,23,23,1,22,22,22,22,22,20,22,1,1,23,0,0,0,0,0,0,0,0,0,0,5,1,1,3,3,3,3,3,3,4,4,5,0,7,1,1,1,18,11,11,0,0,11,11,11,11
23,23,23,23,23,23,23,23,23,23,23,23,23,23,23,1,1,1,1,1,1,23,23,23,23,23,23,23,0,0,0,0,0,5,1,1,3,3,3,3,3,3,3,3,3,4,5,7,1,1,18,11,11,0,0,11,11,11,11,18
23,23,23,23,23,23,23,23,23,23,23,23,23,23,23,23,23,23,23,23,23,23,23,23,23,23,23,23,23,23,23,0,5,1,1,3,3,3,3,3,3,3,3,3,3,4,5,7,1,1,18,11,11,0,11,11,11,11,11,11
23,23,23,23,23,23,23,23,23,23,23,23,23,23,23,23,23,23,23,23,23,23,23,23,23,23,23,23,23,23,23,5,1,1,3,2,2,2,2,3,3,3,3,3,3,3,4,7,1,18,11,11,0,0,11,11,11,11,11,11
23,23,23,23,23,23,23,23,23,23,23,23,23,23,23,23,23,23,23,23,23,23,7,23,23,23,23,23,23,23,5,1,1,3,2,2,2,2,2,2,2,3,3,3,3,3,3,7,1,18,11,11,0,11,11,11,18,11,11,1
23,23,23,23,23,23,23,23,23,23,23,23,23,23,23,23,23,23,23,23,23,7,18,23,23,23,23,23,23,5,1,1,2,2,2,2,2,2,2,2,2,2,3,3,3,3,3,7,18,11,11,0,11,11,11,18,11,22,1,1
23,23,23,23,23,23,23,23,23,23,23,23,23,23,23,23,23,23,23,23,7,7,23,23,23,23,23,23,5,1,1,2,2,2,2,2,2,2,2,2,2,2,3,3,3,1,1,7,11,11,11,0,11,11,18,11,22,1,1,1
23,23,23,23,23,23,23,23,23,23,23,23,23,23,23,23,23,23,23,23,7,7,23,23,23,23,23,23,5,1,1,2,2,2,2,2,2,2,2,2,2,2,2,3,3,1,7,11,11,11,11,11,11,18,11,11,22,1,1,1
23,23,23,23,23,23,23,23,23,23,23,23,23,23,23,23,23,23,23,23,7,18,23,23,23,23,23,5,1,1,2,2,2,2,2,2,2,2,2,2,2,2,2,4,1,1,7,11,11,11,11,11,18,11,11,22,22,1,1,0
23,23,23,23,23,23,23,23,23,23,23,23,23,23,23,23,23,23,23,7,8,18,23,23,23,23,23,5,1,2,2,2,2,2,2,2,2,2,2,2,2,2,2,4,1,4,7,11,11,11,11,18,11,11,1,1,1,1,0,0
23,23,23,23,23,23,23,23,23,23,23,23,23,23,23,23,23,23,23,7,8,18,23,23,23,23,5,1,1,2,2,2,2,2,2,2,2,2,2,2,2,2,2,4,5,5,7,11,11,11,18,11,11,1,1,1,1,0,0,0
23,23,23,23,23,23,23,23,23,23,23,23,23,23,23,23,23,23,23,7,8,18,23,23,23,23,5,1,2,2,2,2,2,2,2,2,2,2,2,2,2,2,2,5,16,7,11,11,11,11,18,11,1,1,22,1,1,0,0,0
23,23,23,23,23,23,23,23,23,23,23,23,23,23,23,23,23,23,23,7,9,18,23,23,23,5,1,1,2,2,2,2,2,2,2,2,2,2,2,2,2,2,4,5,16,7,11,11,11,18,11,1,1,22,1,1,0,0,0,0
23,23,23,23,23,23,23,23,23,23,23,23,23,23,23,23,23,23,23,7,18,18,23,23,23,5,1,2,2,2,2,2,1,1,1,1,1,1,2,2,2,4,5,16,7,11,11,11,11,18,11,1,22,22,1,1,0,0,0,11
23,23,23,23,23,23,23,23,23,23,23,23,23,23,23,23,23,23,23,7,9,18,23,23,23,1,1,2,2,2,1,1,20,20,22,22,22,22,1,1,4,5,16,7,11,11,11,11,18,11,1,1,22,22,1,1,0,0,11,11
23,23,23,23,23,23,23,23,23,23,23,23,23,23,23,23,23,23,23,7,8,18,18,23,5,1,2,2,2,1,20,20,20,20,19,19,19,22,20,20,1,16,7,11,11,11,7,7,16,11,1,22,22,22,1,1,0,0,11,11
23,23,23,23,23,23,23,23,23,23,23,23,23,23,23,23,23,23,23,7,8,18,18,23,5,1,2,2,1,20,20,20,20,20,19,19,2,22,19,20,20,20,7,11,11,7,16,7,16,11,1,22,22,1,1,11,0,11,11,11
23,23,23,23,23,23,23,23,23,23,23,23,23,23,23,23,23,23,23,23,7,8,18,18,1,1,2,2,1,20,20,20,20,20,19,2,3,22,4,5,16,20,11,11,7,16,16,7,16,16,1,22,1,1,0,11,11,11,11,18
23,23,23,23,23,23,23,23,23,23,23,23,23,23,23,23,23,23,23,23,7,23,23,5,1,2,2,1,20,20,19,19,19,20,20,3,3,4,5,16,7,20,1,7,16,16,16,7,16,16,1,1,1,0,11,11,11,11,18,11
23,23,23,23,23,23,23,23,23,23,23,23,23,23,23,23,23,8,23,23,23,7,7,5,1,2,2,1,20,19,19,19,19,15,15,3,4,5,16,7,11,20,1,7,16,16,16,7,16,16,1,1,0,11,11,11,11,18,11,11
23,23,23,23,23,23,23,23,23,23,23,23,23,23,23,23,23,23,8,23,23,23,5,1,2,2,2,1,20,19,19,19,15,15,15,4,5,16,22,7,11,20,1,16,16,16,16,7,16,16,1,11,11,11,11,11,18,11,11,11
23,23,23,22,22,22,22,22,22,22,23,23,23,23,23,23,23,23,23,8,23,23,5,1,2,2,2,1,19,19,19,19,15,15,15,5,16,22,22,11,11,20,1,16,16,16,16,7,16,16,0,11,11,11,11,18,11,11,11,11
22,22,22,22,22,22,22,22,22,21,22,22,22,23,23,23,23,23,23,23,8,8,5,2,2,2,2,22,19,19,19,19,15,18,18,7,16,16,16,11,7,20,1,16,16,16,16,7,16,11,11,11,11,11,11,11,11,11,11,11
22,22,22,21,21,21,21,21,21,21,21,21,22,22,23,23,23,23,23,23,23,5,1,2,2,2,2,22,6,6,19,19,15,18,18,22,22,22,16,11,22,1,16,16,16,16,16,7,16,11,11,11,11,11,11,11,11,11,11,11
21,21,21,21,19,19,19,21,21,21,21,21,21,22,22,22,22,22,22,22,22,5,2,2,2,2,2,2,1,6,19,19,15,15,18,22,22,16,16,22,22,1,16,16,16,16,16,7,16,11,11,11,11,0,0,0,11,11,11,11
21,13,19,19,19,19,19,19,19,19,19,21,21,21,21,21,21,21,21,21,5,1,2,2,2,2,2,2,2,1,6,19,19,15,18,18,7,16,16,22,1,16,16,13,16,16,16,7,16,11,11,11,0,0,0,0,0,11,11,11
21,13,13,13,13,19,19,19,21,21,21,21,21,19,19,19,19,19,19,19,5,1,2,2,2,2,2,2,2,2,1,22,21,15,18,22,22,22,22,1,16,16,16,13,16,16,16,7,16,1,1,0,0,0,0,0,0,0,11,11
19,21,13,21,13,13,13,21,19,19,19,19,21,21,19,19,19,19,19,5,1,2,2,2,2,2,2,2,2,2,3,14,1,1,1,1,1,1,7,16,16,16,16,13,16,16,16,7,16,1,1,1,0,0,0,0,0,0,11,11
19,19,19,19,21,21,21,21,19,13,19,19,19,19,21,19,19,19,19,5,2,2,2,2,2,2,2,2,2,3,5,23,7,15,18,18,18,18,7,16,16,16,13,13,16,16,16,7,16,1,1,1,1,1,0,0,0,0,0,11
19,19,19,19,19,19,19,21,21,13,13,19,19,13,21,13,13,13,13,5,2,2,2,2,2,2,2,2,3,5,7,23,16,7,7,18,18,18,7,16,16,13,13,13,13,16,16,16,7,1,1,1,1,1,1,0,0,0,0,11
13,13,13,13,19,19,19,13,13,13,13,13,13,13,21,21,21,21,5,1,2,2,2,2,2,2,2,2,3,7,7,23,13,13,7,18,18,18,7,16,13,13,13,13,13,16,16,16,7,1,1,1,1,1,1,0,0,0,0,11
21,21,21,13,13,13,19,19,19,21,21,21,21,21,19,13,13,13,5,2,2,2,2,2,2,2,3,3,5,7,7,23,13,13,16,7,18,18,7,16,13,13,13,13,13,16,16,16,7,1,1,1,1,1,1,1,0,0,0,11
19,19,21,21,21,13,13,13,19,19,13,13,13,13,13,21,21,21,5,2,2,2,2,2,2,2,3,5,19,19,7,23,12,13,13,7,18,18,7,13,13,13,13,13,13,13,16,16,7,1,1,1,1,1,1,1,0,0,0,11
19,19,19,19,21,21,21,21,13,13,13,21,21,21,21,21,19,5,1,2,2,2,2,2,2,2,3,4,19,19,19,23,12,13,13,16,7,18,7,13,13,13,13,13,13,13,16,16,7,1,1,1,1,1,1,1,0,0,0,0
19,19,13,13,13,21,19,19,21,21,21,21,19,19,21,19,19,5,2,2,2,2,2,2,2,3,5,19,19,19,19,21,23,12,13,13,13,7,7,13,12,13,13,13,13,13,16,16,7,1,1,1,1,1,1,1,1,1,1,1
13,13,21,21,19,19,19,19,19,19,19,19,19,19,21,7,7,1,2,2,2,2,2,2,3,3,5,19,19,19,19,21,23,12,13,13,13,16,7,13,12,13,13,13,13,13,13,16,7,1,1,1,22,1,1,1,1,1,1,22
13,21,21,19,19,19,19,19,19,19,19,19,19,19,7,15,15,7,2,2,2,2,2,2,3,5,19,19,19,19,13,21,23,12,13,13,13,13,7,13,12,13,7,13,13,13,13,16,7,1,1,1,1,1,1,1,1,22,22,22
21,19,19,19,19,19,19,19,19,19,19,19,19,19,7,21,15,7,4,4,4,4,2,3,3,5,13,13,13,13,13,21,19,23,12,13,13,13,16,13,12,12,18,7,13,13,13,16,7,1,1,22,1,1,1,1,22,22,22,22
19,19,19,19,19,19,19,19,19,19,19,19,19,19,7,7,7,1,7,7,7,7,4,4,5,21,21,21,21,21,21,21,19,23,12,12,13,13,13,23,12,12,18,18,7,13,13,16,7,1,1,22,22,1,1,22,22,22,22,22
19,19,19,19,19,19,19,19,19,19,19,19,19,19,19,4,1,1,1,7,21,7,4,4,5,19,21,21,21,19,19,19,21,19,23,12,13,16,18,23,12,12,18,18,18,7,13,16,7,1,22,22,22,1,1,22,22,22,22,22
19,19,20,20,20,20,20,20,13,13,13,13,13,13,4,1,2,2,2,7,7,7,7,7,19,7,7,19,19,19,19,19,19,21,23,12,12,13,18,23,12,12,12,18,18,7,13,7,11,1,22,22,22,1,1,1,1,1,22,22
20,20,20,20,13,13,20,20,20,20,20,20,20,20,4,1,2,2,2,2,7,1,1,7,7,1,1,7,19,19,19,19,19,19,19,23,12,13,18,18,23,12,12,18,18,7,13,7,11,1,22,22,22,1,1,1,1,1,1,22
20,20,13,13,13,19,13,13,13,13,13,13,19,4,1,2,2,2,2,2,2,7,1,7,1,0,1,1,7,19,19,19,19,19,19,23,12,12,13,18,23,12,12,18,18,7,13,7,11,1,22,22,22,1,1,1,1,1,1,22
13,13,19,19,19,19,19,19,19,19,19,19,19,4,1,2,2,2,2,2,2,3,7,7,17,0,1,1,1,7,19,19,19,19,19,19,23,12,12,18,18,23,12,16,18,7,13,7,11,1,22,22,22,22,1,1,1,1,1,1
0.9100379,0.9529881,0.9609015
1,0.9803922,0.9529412
1,0.9176471,0.9176471
1,0.854902,0.882353
1,0.7372549,0.7607844
0.9294118,0.5333334,0.509804
1,0.5254902,0.6470588
0.203451,0.3402353,0.5122092
0.3803922,0.4862745,0.5215687
0.5607843,0.6745098,0.7137255
0.6509804,0.7843138,0.8941177
0.7019608,0.8666667,1
0.5803922,0.8156863,1
0.3803922,0.7294118,1
0.4941177,0.6470588,0.9529412
0.4745098,0.5450981,0.9450981
0.3803922,0.6078432,1
0.2235294,0.3058824,0.7137255
0.3058824,0.4941177,0.7294118
0.2980392,0.8235295,0.937255
0.7333333,1,0.9450981
0.4078432,1,0.882353
0.9803922,1,0.8745099
0.9764706,0.9254903,0.7568628