1
35-2
False,0
False,0
50,50
0,0,0,0,0,0,2,5,6,6,6,6,6,6,6,6,6,6,6,6,6,6,6,6,5,5,6,6,6,6,6,6,6,6,5,5,5,5,5,5,5,6,6,6,6,6,6,6,6,6
0,0,0,0,0,0,2,5,6,6,6,6,6,6,6,6,6,6,6,6,6,6,6,5,5,6,6,6,6,6,6,6,6,6,5,5,5,5,5,5,5,6,6,6,6,6,6,6,5,5
0,0,2,2,2,2,2,5,6,6,6,6,6,6,6,6,6,6,5,5,5,5,5,5,6,6,6,6,6,6,6,6,6,6,5,5,5,5,5,5,5,6,6,6,6,6,5,5,5,5
0,2,2,2,2,2,2,5,6,6,6,6,6,6,6,6,6,5,5,6,6,6,6,5,4,4,4,4,4,6,6,6,6,6,5,5,5,5,5,5,5,6,6,6,6,6,5,5,5,5
3,2,2,2,2,2,2,5,6,6,6,6,6,6,6,6,5,5,6,6,6,6,6,6,4,4,4,4,4,6,6,6,6,6,6,5,5,5,5,5,6,6,6,6,6,6,5,5,5,5
3,2,2,2,2,2,2,5,6,6,6,6,6,6,6,6,5,5,6,6,6,6,6,6,4,4,4,4,4,6,6,6,6,6,6,6,6,6,6,6,6,6,6,6,6,6,5,5,5,5
0,5,5,5,2,2,5,6,5,6,6,6,6,6,6,6,6,5,5,5,6,6,6,6,4,4,4,4,4,6,6,5,5,5,5,5,5,6,6,6,6,6,6,6,6,6,5,5,5,5
5,6,6,6,5,5,6,6,6,5,6,6,6,6,6,6,6,6,6,6,6,6,6,6,4,4,4,4,4,6,6,5,5,5,5,5,5,5,5,5,5,5,5,5,5,6,5,5,5,5
5,6,6,6,6,5,6,6,6,5,5,6,6,5,5,5,6,6,6,6,6,6,6,6,6,6,6,6,6,6,6,5,5,5,5,5,5,5,5,5,5,5,5,5,5,6,5,5,5,5
5,6,6,6,6,5,6,6,6,6,5,5,5,5,5,5,5,6,6,5,5,5,5,5,5,6,6,6,6,6,6,5,5,5,5,5,5,5,5,5,5,5,5,5,5,6,6,5,5,5
5,6,6,6,6,6,6,6,6,6,5,5,5,5,5,5,5,5,5,5,5,5,5,5,5,5,6,6,6,6,6,5,5,5,5,5,5,5,5,5,5,5,5,5,4,4,4,4,4,6
6,6,6,6,6,6,6,6,6,6,5,5,5,5,5,5,5,5,5,5,5,5,5,5,5,5,6,6,6,6,6,6,6,5,5,5,5,5,5,5,5,5,5,5,4,4,4,4,4,4
6,6,6,6,6,6,6,6,6,6,5,5,5,5,5,5,5,5,5,5,5,5,5,5,5,5,6,6,6,6,6,6,5,5,5,5,5,5,5,5,5,5,5,6,4,4,4,4,4,4
6,6,6,6,6,6,6,6,6,6,5,5,5,5,5,5,5,5,5,5,5,5,5,5,5,4,4,4,4,4,4,6,5,5,5,5,5,5,5,5,5,6,6,6,4,4,4,4,4,4
6,6,6,6,6,6,6,6,6,6,6,5,5,5,5,5,5,5,5,5,5,5,5,5,5,4,4,4,4,4,4,6,5,5,5,5,5,5,5,5,6,6,6,6,4,4,4,4,4,6
6,6,6,6,6,6,6,6,6,5,5,5,5,5,5,5,5,5,5,5,5,5,5,5,5,4,4,4,4,4,4,6,6,5,5,5,5,5,5,6,6,6,6,6,6,6,6,6,6,6
6,6,6,6,6,6,6,6,5,5,5,5,5,5,5,5,5,5,5,5,5,5,5,5,6,4,4,4,4,4,4,5,5,5,4,4,4,4,4,6,6,5,5,5,5,5,6,6,6,6
6,6,6,6,6,6,6,6,5,5,5,5,5,5,5,5,5,5,5,5,5,5,5,5,5,4,4,4,4,4,4,5,5,4,4,4,4,4,4,4,4,4,4,4,4,4,4,6,6,6
5,6,6,6,6,6,6,6,5,5,5,5,5,5,5,5,5,5,5,5,5,5,5,5,5,6,5,5,5,5,5,5,5,4,4,4,4,4,4,4,4,4,4,4,4,4,4,5,6,6
1,5,5,6,6,6,6,6,5,5,5,5,5,5,5,5,5,5,5,5,5,5,5,5,5,6,5,5,5,5,5,5,5,4,4,4,4,4,4,4,4,4,4,4,4,4,4,5,6,6
1,1,1,5,6,6,6,6,5,5,5,5,5,5,5,5,5,5,5,5,5,5,5,5,5,6,6,5,5,5,5,5,5,4,4,4,4,4,4,4,4,4,4,4,4,4,4,5,6,6
1,1,5,6,6,6,6,6,6,5,5,5,5,5,5,6,5,5,5,5,5,5,5,5,5,6,6,6,5,5,5,5,5,4,4,4,4,4,4,4,4,4,4,4,4,4,4,6,6,6
1,1,5,6,6,6,6,6,6,6,6,6,6,6,6,6,6,6,4,4,4,4,4,5,5,6,6,6,6,6,6,6,6,6,4,4,4,4,4,4,4,4,4,4,4,4,4,6,6,6
1,5,6,6,6,6,6,6,6,6,6,6,6,5,5,5,5,4,4,4,4,4,4,4,6,5,5,5,5,5,6,6,6,4,4,4,4,4,4,4,4,4,4,4,4,4,6,6,6,6
1,5,6,6,6,6,6,6,6,6,6,6,6,5,5,5,5,4,4,4,4,4,4,4,6,5,5,5,5,5,5,6,6,4,4,4,4,4,4,4,4,4,4,4,4,6,6,6,6,6
1,5,6,6,6,6,6,6,6,6,6,6,6,5,5,5,5,4,4,4,4,4,4,4,6,5,5,5,5,5,5,5,5,4,4,4,4,4,4,4,4,4,4,4,4,6,6,6,6,6
1,5,6,6,6,6,6,6,6,6,6,6,6,5,5,5,5,4,4,4,4,4,4,4,6,5,5,5,5,5,5,5,5,4,4,4,4,4,4,4,4,4,4,4,4,6,6,6,6,6
0,5,6,6,6,6,6,6,5,5,5,5,6,5,5,5,5,4,4,4,4,4,4,4,6,5,5,5,5,5,5,5,5,4,4,4,4,4,4,4,4,4,4,4,4,4,6,6,6,6
5,5,5,5,6,5,5,5,5,5,5,5,5,6,5,5,5,5,4,4,4,4,4,6,6,6,5,5,5,5,5,5,5,5,4,4,4,4,4,4,4,4,4,4,4,5,5,5,5,6
6,6,6,6,6,5,5,5,5,5,5,5,5,5,6,6,6,6,6,6,6,6,6,6,6,6,5,5,5,5,5,5,5,5,5,5,5,5,6,6,4,4,4,4,4,5,5,5,5,5
6,6,6,6,6,5,5,5,5,5,5,5,5,5,5,6,6,6,6,6,6,6,6,6,6,6,6,6,5,4,4,4,4,4,5,5,5,5,5,5,4,4,4,4,4,5,5,5,5,5
6,6,6,6,6,5,5,5,5,5,5,5,5,5,5,5,5,5,5,5,5,6,6,4,4,4,6,5,5,4,4,4,4,4,5,5,5,5,5,5,5,6,6,5,5,5,5,5,5,5
6,6,6,6,6,5,5,5,5,5,5,5,5,5,5,5,5,5,5,5,5,5,4,4,4,4,4,4,4,4,4,4,4,4,5,5,5,5,5,5,5,6,6,4,4,4,4,4,5,5
6,6,6,6,6,6,5,5,5,5,5,5,5,5,5,5,5,5,5,5,5,5,4,4,4,4,4,4,4,4,4,4,4,4,4,4,4,4,4,4,4,6,4,4,4,4,4,4,4,4
6,6,6,6,6,6,6,5,5,5,5,5,5,5,5,5,5,5,5,5,5,5,4,4,4,4,4,4,4,4,4,4,4,4,4,4,4,4,4,4,4,6,4,4,4,4,4,4,4,4
6,6,6,6,6,6,6,6,5,5,5,5,5,5,5,5,5,5,5,5,5,5,4,4,4,4,4,4,4,4,4,4,4,4,4,4,4,4,4,4,4,6,4,4,4,4,4,4,4,4
6,6,6,6,6,6,5,5,5,5,5,5,5,5,5,5,5,5,5,5,5,5,6,4,4,4,4,4,4,4,4,4,4,4,4,4,4,4,4,4,4,6,4,4,4,4,4,4,4,4
6,6,6,6,5,5,5,5,5,5,5,5,5,5,5,5,5,5,5,5,5,6,6,6,6,4,4,4,4,4,4,4,4,4,4,4,4,4,4,4,6,6,4,4,4,4,4,4,4,4
6,6,6,5,5,5,5,5,5,5,5,5,5,5,5,5,5,5,5,6,6,6,6,6,6,4,4,4,4,4,4,4,4,4,4,4,4,6,6,6,6,6,4,4,4,4,4,4,4,4
6,6,5,5,5,5,5,5,5,5,5,5,5,5,5,5,5,5,5,5,6,6,6,6,4,4,4,4,4,4,4,4,4,4,4,4,4,4,4,6,6,6,4,4,4,4,4,4,4,4
6,6,5,5,5,5,5,5,5,5,5,5,5,5,5,5,5,5,5,5,5,6,6,6,4,4,4,4,4,4,4,4,4,4,4,4,4,4,4,4,6,6,4,4,4,4,4,4,4,4
6,6,5,5,5,5,5,5,5,5,5,5,5,5,5,5,5,5,5,5,5,5,6,6,4,4,4,4,4,4,4,4,4,4,4,4,4,4,4,4,6,6,4,4,4,4,4,4,4,4
6,6,6,5,5,5,5,5,5,5,5,5,5,5,5,5,5,5,5,5,5,5,5,6,4,4,4,4,4,4,4,6,6,4,4,4,4,4,4,4,6,6,5,5,4,4,4,4,4,6
6,6,6,5,5,5,5,5,5,5,5,5,6,6,5,5,5,5,5,5,5,5,5,6,4,4,4,4,4,4,6,6,6,4,4,4,4,4,4,6,6,6,5,5,5,5,5,6,6,6
6,6,6,6,6,5,5,5,5,5,5,6,6,6,6,5,5,5,5,5,5,5,5,6,4,4,4,4,4,5,5,5,6,6,6,5,5,5,5,5,5,6,6,6,6,6,6,6,6,6
6,6,6,6,6,6,6,6,6,6,6,6,6,6,6,5,5,5,5,5,5,5,5,6,6,6,5,5,5,5,5,5,5,6,5,5,5,5,5,5,5,6,6,6,6,6,6,6,6,6
6,6,6,6,6,6,6,6,6,6,6,6,6,6,6,6,5,5,5,5,5,5,6,6,6,6,5,5,5,5,5,5,5,5,5,5,5,5,5,5,5,6,6,6,6,6,6,6,6,6
6,6,6,6,6,6,6,6,6,6,6,6,6,6,6,6,6,6,6,6,6,6,6,6,6,6,6,5,5,5,5,5,5,5,5,5,5,5,5,5,5,6,6,6,6,6,6,6,6,6
6,6,6,6,6,6,6,6,6,6,6,6,6,6,6,6,6,6,6,6,6,6,6,6,6,6,6,5,5,5,5,5,5,5,5,5,5,5,5,5,5,6,6,6,6,6,6,6,6,6
6,6,6,6,6,6,6,6,6,6,6,6,6,6,6,6,6,6,6,6,6,6,6,6,6,6,6,6,5,5,5,5,5,5,5,5,5,5,5,6,6,6,6,6,6,6,6,6,6,6
0.1372549,0.3058824,0.6156863
0.227451,0.03137255,0.3764706
0.09803922,0.06666667,0.3254902
0.09019608,0.4941177,0.4627451
0.9843138,0.8627452,0.8627452
0.9058824,0.7921569,1
0.8039216,0.5647059,1