1
51-11
False,0
False,0
60,60
0,3,1,1,1,1,1,3,0,0,6,10,10,10,10,10,10,10,10,10,10,10,10,10,10,10,10,10,10,5,5,5,3,3,3,3,3,3,3,3,3,3,3,3,3,3,3,3,3,3,3,3,3,3,3,3,3,3,3,3
3,0,1,1,1,1,3,0,0,0,6,10,10,10,10,10,10,10,10,10,10,10,10,10,10,10,10,10,10,5,5,5,0,3,3,3,3,3,3,3,3,3,3,3,3,3,3,3,3,3,3,3,3,3,3,3,3,3,3,3
3,1,1,1,1,1,3,0,0,0,6,10,10,10,10,10,10,10,10,10,10,10,10,10,10,10,10,10,10,5,5,5,0,3,3,3,3,3,3,3,3,3,3,3,3,3,3,3,3,3,3,3,3,3,3,3,3,3,3,3
0,1,1,1,1,3,0,0,0,0,6,10,10,10,10,10,10,10,10,10,10,10,10,10,10,10,10,10,10,5,5,5,0,3,3,3,3,3,3,3,3,3,3,3,3,3,3,3,3,3,3,3,3,3,3,3,3,3,3,3
0,1,1,1,1,3,0,0,0,6,10,10,10,10,10,10,10,10,10,10,10,10,10,10,10,10,10,10,5,5,5,5,0,3,3,3,3,3,3,3,3,3,3,3,3,3,3,3,3,3,3,3,3,3,3,3,3,3,3,0
0,1,1,1,3,0,0,0,0,6,10,10,10,10,10,10,10,10,10,10,10,10,10,10,10,10,10,10,5,5,5,5,0,3,3,3,3,3,3,0,0,0,0,0,0,0,3,3,3,3,3,3,3,3,3,3,3,3,3,3
1,1,1,1,0,0,0,0,0,6,10,10,10,10,10,10,10,10,10,10,10,10,10,10,10,10,10,5,5,5,5,5,0,3,3,3,3,0,0,0,0,0,0,0,0,0,0,0,0,0,3,3,3,3,3,3,3,3,3,3
1,1,1,0,0,0,0,0,0,6,10,10,10,10,10,10,10,10,10,10,10,10,10,10,10,10,10,5,5,5,5,5,3,3,3,3,3,0,0,0,0,0,0,0,0,0,0,0,0,0,0,0,0,3,3,3,3,3,3,3
1,1,0,0,0,0,0,0,0,6,10,10,10,10,10,10,10,10,10,10,10,10,10,10,10,10,5,0,5,5,5,5,3,3,3,3,3,0,0,0,0,0,0,0,0,0,0,0,0,0,0,0,0,0,0,3,3,3,3,3
1,1,0,0,0,0,0,0,0,6,10,10,10,10,10,10,10,10,10,10,10,10,10,10,10,10,5,3,5,5,5,5,3,3,0,0,0,0,0,0,0,0,0,0,0,0,0,0,0,0,0,0,0,0,0,0,3,3,3,3
1,0,0,0,0,0,0,0,6,10,10,10,10,10,10,10,10,10,10,10,10,10,10,10,10,5,3,3,5,5,5,5,3,3,0,0,0,0,0,0,0,0,0,0,0,0,0,0,0,0,0,0,0,0,0,0,0,3,3,3
0,0,0,0,0,0,0,0,6,9,9,9,10,10,10,10,10,10,9,9,9,10,10,10,10,5,3,3,5,5,5,5,3,0,0,0,0,0,0,0,0,0,0,0,0,0,0,0,0,0,0,0,0,0,0,0,0,0,3,3
0,0,0,0,0,0,0,0,6,9,9,9,10,10,10,10,10,10,9,9,9,10,10,10,5,3,3,3,5,5,5,8,0,0,0,0,0,0,0,0,0,0,0,0,0,0,0,0,0,0,0,0,0,0,0,0,0,0,0,3
0,0,0,0,0,0,0,0,6,9,9,9,10,10,10,10,10,10,9,9,9,10,10,10,5,3,3,3,5,5,5,8,0,0,0,0,0,0,0,0,0,0,0,0,0,0,0,0,0,0,0,0,0,0,0,0,0,0,0,0
0,0,0,0,0,0,0,0,6,10,10,10,10,10,10,10,10,10,9,9,9,10,10,5,3,3,3,3,5,5,5,5,0,0,0,0,0,0,0,0,0,0,0,0,0,0,0,0,0,0,0,0,0,0,0,0,0,0,0,0
0,0,0,0,0,0,0,0,4,10,10,10,10,10,10,10,10,10,10,10,10,10,10,5,3,3,3,5,5,5,5,5,0,0,0,0,0,0,0,0,0,0,0,0,0,0,0,0,0,0,0,0,0,0,0,0,0,0,0,0
0,0,0,0,0,0,0,6,10,10,10,10,10,10,10,10,10,10,10,10,10,10,5,3,3,3,3,5,5,5,5,5,0,0,0,0,0,0,0,0,0,0,0,0,0,0,0,0,0,0,0,0,0,0,0,0,0,0,0,0
0,0,0,0,0,0,0,6,10,10,10,10,10,10,10,10,10,10,10,10,10,10,5,3,3,3,3,5,5,5,5,5,0,0,0,0,0,0,0,0,0,0,0,0,0,0,0,0,0,0,0,0,0,0,0,0,0,0,0,0
0,0,0,0,0,0,6,10,10,10,9,9,9,10,10,10,10,10,10,10,10,5,3,3,3,3,3,5,5,5,5,5,0,0,0,0,0,0,0,0,0,0,0,0,0,0,0,0,0,0,0,0,0,0,0,0,0,0,0,0
0,0,0,0,0,0,6,9,9,9,9,9,9,10,9,9,9,9,10,10,10,5,3,3,3,3,5,5,5,5,5,5,0,0,0,0,0,0,0,0,0,0,0,0,0,0,0,0,0,0,0,0,0,0,0,0,0,0,0,0
0,0,0,0,0,0,6,9,9,9,9,9,9,9,9,9,9,9,9,9,5,3,3,3,3,3,5,5,5,5,5,5,0,0,0,0,0,0,0,0,0,0,0,0,0,0,0,0,0,0,0,0,0,0,0,0,0,0,0,0
0,0,0,0,0,0,6,9,9,9,9,9,9,9,9,9,9,9,9,9,5,3,3,3,3,3,5,5,5,5,5,5,1,0,0,0,0,0,0,0,0,0,0,0,0,0,0,0,0,0,0,0,0,0,0,0,0,0,0,0
0,0,0,0,0,0,6,9,9,9,9,9,9,9,9,9,9,9,9,5,3,3,3,3,3,3,5,5,5,5,5,5,1,0,0,0,0,0,0,0,0,0,0,0,0,0,0,0,0,0,0,0,0,0,0,1,0,0,0,0
0,0,0,0,0,0,6,9,9,9,9,9,9,9,9,9,9,9,9,5,3,3,3,3,3,3,5,5,5,5,5,5,1,1,0,0,0,0,0,0,0,0,0,0,0,0,0,0,0,0,0,0,0,0,0,1,0,0,0,0
0,0,0,0,0,0,6,9,9,9,9,9,9,9,9,9,9,9,5,3,3,3,3,3,3,3,5,5,5,5,5,5,5,1,0,0,0,0,0,0,0,0,0,0,0,0,0,0,0,0,0,0,0,0,0,1,1,1,1,0
0,0,0,0,0,0,6,9,9,9,9,9,9,9,9,9,9,9,5,3,3,3,3,3,3,3,5,5,5,5,5,5,5,1,1,0,0,0,0,0,0,0,0,0,0,0,0,0,0,0,0,0,0,0,0,1,1,1,1,0
0,0,0,0,0,0,6,9,9,9,9,9,9,9,9,9,9,5,3,3,3,3,3,3,3,3,5,5,5,5,5,5,5,1,1,0,0,0,0,0,0,0,0,0,0,0,0,0,0,0,0,0,0,0,1,1,1,1,1,0
0,0,0,0,0,0,6,9,9,9,9,9,9,9,9,9,9,5,3,3,3,3,3,3,3,0,5,5,5,5,5,5,5,1,1,1,0,0,0,0,0,0,0,0,0,0,0,0,0,0,0,0,0,0,1,1,1,1,1,0
0,3,0,0,0,0,6,9,9,9,9,9,9,9,9,9,5,3,3,3,3,3,3,3,0,0,5,5,5,5,5,5,5,1,1,1,0,0,0,0,0,0,0,0,0,0,0,0,0,0,0,0,0,1,1,1,1,1,1,0
0,3,0,0,0,0,6,9,9,9,9,9,9,9,9,9,5,3,3,3,3,3,3,0,0,0,5,5,5,5,5,5,5,1,1,1,1,0,0,0,0,0,0,0,0,0,0,0,0,0,0,0,0,1,1,1,1,1,1,0
0,3,0,0,0,0,6,9,9,9,9,9,9,9,9,5,3,3,3,3,3,3,3,0,0,0,5,5,5,5,5,5,5,5,1,1,1,1,0,0,0,0,0,0,0,0,0,0,0,0,0,0,0,1,1,1,1,1,1,0
0,3,0,0,0,0,6,9,9,9,9,9,9,9,9,5,3,3,3,3,3,3,0,0,0,0,5,5,5,5,5,5,5,5,1,1,1,1,0,0,0,0,0,0,0,0,0,0,0,0,0,0,0,1,1,1,1,1,1,0
0,3,0,0,0,0,6,9,9,9,9,9,9,9,5,1,3,3,3,3,3,0,0,0,0,0,5,5,5,5,5,5,5,5,1,1,1,1,0,0,0,0,0,0,0,0,0,0,0,0,0,0,0,1,1,1,1,1,1,0
0,3,0,0,0,0,6,9,9,9,9,9,9,10,5,1,1,3,3,3,0,0,0,0,0,0,5,5,5,5,5,5,5,5,1,1,1,1,1,0,0,0,0,0,0,0,0,0,0,0,0,0,0,1,1,1,1,1,1,1
0,3,0,0,0,0,6,9,9,9,9,9,9,5,1,1,3,3,3,0,0,0,0,0,0,0,0,5,5,5,5,5,5,5,1,1,1,1,1,1,0,0,0,1,1,1,0,0,0,0,0,0,0,1,1,1,1,1,1,1
5,5,5,5,0,0,6,9,9,9,9,9,5,1,1,1,3,3,0,0,0,0,0,0,0,0,0,5,5,5,5,5,5,5,1,1,1,1,1,1,1,1,1,1,1,1,1,0,0,0,0,0,0,1,1,1,1,1,1,1
7,7,7,5,5,5,5,9,9,9,9,9,5,1,1,1,1,3,0,0,0,0,0,0,0,0,0,5,5,5,5,5,5,5,5,1,1,1,1,1,1,1,1,1,1,1,1,1,0,0,0,0,0,1,1,1,1,1,1,1
7,7,7,7,7,7,5,9,9,9,9,5,1,1,1,1,1,3,0,0,0,0,0,0,0,0,0,5,5,5,5,5,5,5,5,1,0,0,0,0,1,1,1,1,1,1,1,1,1,1,1,1,1,1,1,1,1,1,1,1
7,7,7,7,7,7,5,9,9,9,9,5,1,1,1,1,1,3,0,0,0,0,0,0,0,0,0,5,5,5,5,5,5,5,5,1,0,0,0,0,0,1,1,1,1,1,1,1,1,1,1,1,1,1,1,1,1,1,1,1
7,7,7,7,7,7,5,9,9,9,9,5,1,1,1,1,1,3,0,0,0,0,0,0,0,0,0,5,5,5,5,5,5,5,5,1,0,0,0,0,0,1,1,1,1,1,1,1,1,1,1,1,1,1,1,1,1,1,1,1
7,7,7,7,7,7,5,9,9,9,5,1,1,1,1,1,1,3,0,0,0,0,0,0,0,0,0,5,5,5,5,5,5,5,5,5,0,0,0,0,0,1,1,1,1,1,1,1,1,1,1,1,1,1,1,1,1,1,1,1
5,5,5,5,5,5,5,9,9,9,5,1,1,1,1,1,1,3,0,0,0,0,0,0,0,0,0,5,5,5,5,5,5,5,5,5,1,0,0,0,1,1,1,1,1,1,1,1,1,1,1,1,1,1,1,1,1,1,1,1
3,3,3,3,3,3,9,6,6,9,5,1,1,1,1,1,1,3,0,0,0,0,0,0,0,0,0,5,5,5,5,5,5,5,5,5,1,1,1,1,1,1,1,1,1,1,1,1,1,1,1,1,1,1,1,1,1,1,1,1
3,3,3,3,3,3,3,3,3,6,5,3,1,1,1,1,1,3,0,0,0,0,0,0,0,0,0,5,5,5,5,5,5,5,5,5,5,1,1,1,1,1,1,1,1,1,1,1,1,1,1,1,1,1,1,1,1,1,1,1
3,3,3,3,3,3,3,3,3,3,3,6,2,1,1,1,1,3,3,0,0,0,0,0,0,0,0,5,5,5,5,5,5,5,5,5,5,1,1,1,1,1,1,1,1,1,1,1,1,1,1,1,1,1,1,1,1,1,1,1
3,3,3,3,3,3,3,3,3,3,3,3,6,2,3,1,1,1,3,0,0,0,0,0,0,0,0,5,5,5,5,5,5,5,5,5,5,1,1,1,1,1,1,1,1,1,1,1,1,1,1,1,1,1,1,1,1,1,1,1
3,3,3,3,3,3,3,3,3,3,3,3,3,6,3,3,1,1,3,0,0,0,0,0,0,0,0,5,5,5,5,5,5,5,5,5,5,1,1,1,1,1,1,1,1,1,1,1,1,1,1,1,1,1,1,1,1,1,1,1
3,3,3,3,3,3,3,3,3,3,3,3,3,2,6,3,1,1,1,3,0,0,0,0,0,0,0,5,5,5,5,5,5,5,5,5,5,5,1,1,1,1,1,1,1,1,1,1,1,1,1,1,1,1,1,1,1,1,1,1
0,0,0,0,0,0,3,3,3,3,3,3,3,2,6,2,1,1,1,3,1,0,0,0,0,0,0,0,5,5,5,5,5,5,5,5,5,5,1,1,1,1,1,1,1,1,1,1,1,1,1,1,1,1,1,1,1,1,1,1
0,0,0,0,0,0,0,0,0,0,3,3,3,3,2,6,1,1,1,1,3,1,0,0,0,0,0,0,5,5,5,5,5,5,5,5,5,5,5,1,1,1,1,1,1,1,1,1,1,1,1,1,1,1,1,1,1,1,1,1
0,0,0,0,0,0,0,0,0,0,0,0,0,0,3,6,2,1,1,1,1,3,1,0,0,0,0,0,5,5,5,5,5,5,5,5,5,5,5,1,1,1,1,1,1,1,1,1,1,1,1,1,1,1,1,1,1,1,1,1
0,0,0,0,0,0,0,0,0,0,0,0,0,0,0,2,6,1,1,1,1,1,3,1,0,0,0,0,5,5,5,5,5,5,5,5,5,5,5,5,1,1,1,1,1,1,1,1,1,1,1,1,1,1,1,1,1,1,1,1
0,0,0,0,0,0,0,0,0,0,0,0,0,0,0,2,6,1,1,1,1,1,1,3,1,0,0,0,5,5,5,5,5,5,5,5,5,5,5,5,1,1,1,1,1,1,1,1,1,1,1,1,1,1,1,1,1,1,1,1
0,0,0,0,0,0,0,0,0,0,0,0,0,0,0,0,2,6,0,0,0,0,1,1,3,1,0,0,5,5,5,5,5,5,5,5,5,5,5,5,1,1,1,1,1,1,1,1,1,1,1,1,1,1,1,1,1,1,1,1
0,0,0,0,0,0,0,0,0,0,0,0,0,0,0,0,2,6,0,0,0,0,1,1,1,3,1,0,5,5,5,5,5,5,5,5,5,5,5,5,8,1,1,1,1,1,1,1,1,1,1,1,1,1,1,1,1,1,1,1
0,0,0,0,0,0,0,0,0,0,0,0,0,0,0,0,0,6,0,0,0,0,1,1,1,1,3,1,0,5,5,5,5,5,5,5,5,5,5,5,5,1,1,1,1,1,1,1,1,1,1,1,1,1,1,1,1,1,1,1
0,0,0,0,0,0,0,0,0,0,0,0,0,0,0,0,0,0,6,0,0,1,1,1,1,1,1,3,1,5,5,5,5,5,5,5,5,5,5,5,7,8,1,1,1,1,1,1,1,1,1,1,1,1,1,1,1,1,1,1
1,1,1,0,3,3,3,3,0,0,0,0,0,0,0,0,0,0,6,0,0,1,1,1,1,1,1,1,1,1,5,5,5,5,5,5,5,5,5,5,5,5,1,1,1,1,1,1,0,0,0,0,1,1,1,1,1,1,1,1
1,1,1,1,1,1,1,1,3,3,0,0,0,0,0,0,0,0,6,0,1,1,1,1,1,1,1,1,1,4,5,5,5,5,5,5,5,5,5,5,5,7,5,1,1,1,1,1,0,0,0,0,0,1,1,1,1,1,1,1
1,1,1,1,1,1,1,1,1,1,3,3,0,0,0,0,0,0,6,0,1,1,1,1,1,1,1,1,1,1,1,5,5,5,5,5,5,5,5,5,5,7,5,1,1,1,1,1,0,0,0,0,0,0,1,1,1,1,1,1
0.9921569,0.8784314,0.937255
1,0.9411765,0.9960785
1,1,1
1,0.7764707,0.8392158
0.9137256,0.4901961,0.6078432
0.8431373,0.2431373,0.4
0.9490197,0.372549,0.4901961
0.9490197,0.4196079,0.4196079
0.7215686,0.2470588,0.09803922
0.9176471,0.6745098,0.9803922
0.7764707,0.4980392,1