1
56-1
False,0
False,0
50,50
0,0,0,0,0,0,0,0,0,0,0,0,0,0,10,10,14,14,8,8,8,8,14,14,11,13,13,14,14,14,14,14,8,8,8,8,8,14,14,14,14,10,0,1,1,1,1,1,0,0
0,0,0,0,0,0,0,0,0,0,0,0,0,0,0,0,10,10,14,14,14,14,14,14,10,13,12,13,14,14,14,14,14,14,14,14,14,14,14,10,10,0,0,1,1,1,0,1,0,0
0,0,0,0,0,0,0,0,0,0,0,0,0,0,0,0,0,0,10,10,10,10,10,10,14,13,12,13,10,14,14,14,14,14,14,14,14,10,10,0,0,0,0,0,1,1,1,1,0,0
0,0,0,0,0,0,0,0,0,0,0,0,0,0,0,0,0,1,1,1,1,0,0,0,0,13,12,13,0,10,10,10,10,10,10,10,10,0,0,0,0,0,0,0,0,0,0,0,0,0
0,0,0,0,0,0,0,0,0,0,0,0,0,0,0,0,1,1,1,1,1,0,0,0,0,13,12,13,0,0,0,0,0,0,0,0,0,0,0,0,0,0,0,0,0,0,0,0,0,0
0,0,0,0,0,0,0,0,0,0,0,0,0,0,1,1,1,1,1,1,0,0,0,0,0,0,13,12,13,0,0,0,0,0,0,0,0,0,0,0,0,0,0,0,0,0,0,0,0,0
0,0,0,0,0,0,0,0,4,4,0,0,1,1,1,1,1,1,1,1,0,0,0,0,0,0,13,12,13,0,0,0,0,0,0,0,0,0,0,0,0,0,0,0,0,0,0,0,0,0
0,0,0,0,0,0,0,0,4,4,1,1,1,1,1,1,1,1,1,0,0,0,0,0,0,0,13,12,3,13,0,0,0,0,0,0,0,0,0,0,0,0,0,0,0,0,0,0,0,0
0,0,0,0,0,0,0,4,4,4,1,1,1,1,1,1,1,1,1,0,0,0,0,0,0,0,0,13,12,3,13,0,0,0,0,0,0,0,0,0,0,0,0,0,0,0,0,0,0,0
0,0,0,0,0,0,0,4,4,1,1,1,1,1,1,1,1,1,1,0,0,0,0,0,0,0,0,0,13,12,3,13,13,0,0,0,0,0,0,13,13,13,13,0,0,0,0,0,0,0
0,0,0,0,0,0,0,0,0,1,1,1,1,1,1,1,1,1,1,0,0,0,0,0,0,0,0,0,0,13,12,3,3,13,0,0,0,0,13,12,12,12,13,0,0,0,0,0,0,0
0,0,0,0,0,0,0,0,0,1,1,1,1,1,1,1,1,1,0,0,0,0,0,0,0,0,0,0,0,0,13,12,12,3,13,13,13,13,12,3,13,13,0,0,0,0,0,0,0,0
0,0,0,0,0,0,0,0,0,1,1,1,1,1,1,1,1,1,0,0,0,0,0,0,0,0,0,0,0,0,0,13,13,3,3,3,3,3,3,13,0,0,0,0,0,0,0,0,0,0
10,0,0,0,0,0,0,0,0,1,1,1,1,1,1,1,1,1,0,0,0,0,0,0,0,0,0,0,0,0,0,0,0,13,13,13,13,13,13,0,0,0,0,0,0,0,0,0,0,0
9,10,0,0,0,0,0,0,0,1,1,1,1,1,1,1,1,0,0,0,0,0,0,0,0,0,0,0,0,0,0,0,0,0,0,0,0,0,0,0,0,0,0,0,0,0,0,0,0,0
9,9,10,0,0,0,0,0,0,0,1,1,1,1,1,1,1,0,0,0,0,0,0,0,0,0,0,0,0,0,0,0,0,0,0,0,0,0,0,0,0,0,0,0,0,0,0,0,0,0
9,9,9,10,0,0,0,0,0,0,1,1,1,1,1,1,0,0,0,0,0,0,0,0,0,0,0,0,0,0,0,0,0,0,0,0,0,0,0,0,0,0,0,0,0,0,0,0,0,0
9,9,9,14,10,0,0,0,0,0,1,1,1,1,0,0,0,0,0,0,0,0,0,0,0,7,7,7,0,0,0,0,0,0,0,0,0,0,0,0,0,0,0,0,0,0,0,0,0,0
9,14,14,14,14,10,0,0,0,0,1,1,1,0,0,0,0,0,0,0,0,0,0,0,0,7,7,7,7,0,0,0,0,0,0,0,0,0,0,0,0,0,0,0,0,0,0,0,0,0
14,14,14,4,4,4,4,4,4,4,0,1,0,0,0,0,0,0,0,0,0,0,0,0,0,0,7,7,7,0,0,0,0,0,0,0,0,0,0,0,0,0,0,0,0,0,0,0,0,0
14,14,14,4,4,4,4,4,4,4,4,4,0,0,0,0,0,0,0,0,0,0,0,0,0,0,0,0,0,0,0,0,0,0,0,0,0,0,0,0,0,0,0,0,0,0,0,0,0,0
14,14,14,14,4,4,4,4,4,4,4,4,4,0,0,0,0,0,0,0,0,0,0,0,0,0,0,0,0,0,0,0,0,0,0,0,0,0,0,0,0,0,0,0,0,0,0,0,0,0
14,14,14,14,14,4,4,4,4,4,4,4,4,0,0,0,0,0,0,0,0,0,0,0,0,0,0,0,0,0,0,0,0,0,0,0,0,0,0,0,1,1,0,0,0,0,0,0,0,0
14,14,14,14,14,14,4,4,4,4,4,4,4,0,0,0,0,0,0,0,0,0,0,0,0,0,0,0,0,0,0,0,0,0,0,0,0,0,0,0,1,1,0,0,0,0,0,0,0,0
14,14,14,14,14,14,14,14,4,4,4,0,0,0,0,0,0,0,0,0,0,0,0,0,0,0,0,0,0,0,0,0,0,0,0,0,0,0,0,0,1,1,0,0,0,0,0,0,0,0
14,14,14,14,14,14,14,14,14,14,10,0,0,0,0,0,0,0,0,0,0,0,0,0,0,0,0,0,0,0,0,0,0,0,0,0,0,0,0,0,1,1,1,0,0,0,0,0,0,0
14,14,14,14,14,14,14,14,14,14,14,10,0,0,0,0,0,0,0,0,0,0,0,0,0,0,0,0,0,0,0,0,0,0,0,0,0,0,0,0,1,1,1,0,0,0,0,0,0,0
14,14,14,14,14,14,14,14,14,14,14,10,0,0,0,0,0,0,0,0,0,0,0,0,0,0,0,0,0,0,0,0,0,0,0,0,0,0,0,0,1,1,1,1,0,0,0,0,0,0
14,14,14,14,14,14,14,14,14,14,14,10,1,0,0,0,0,0,0,0,0,0,0,0,0,0,0,0,0,0,0,0,0,0,0,0,0,0,0,0,1,1,1,1,4,4,2,2,2,2
14,14,14,14,14,14,14,14,14,14,14,10,1,0,0,0,0,0,0,0,0,0,0,0,0,0,0,0,0,0,0,0,0,0,0,0,0,0,0,0,1,1,1,1,4,4,4,4,2,7
14,14,14,14,14,14,14,14,14,14,14,10,0,0,0,0,0,0,0,0,0,0,0,0,0,0,0,0,0,0,0,0,0,0,0,0,0,0,0,0,1,1,1,1,0,4,4,4,2,7
14,14,14,14,14,14,14,14,14,14,14,10,0,0,0,0,0,0,0,0,0,0,0,0,0,0,0,0,0,0,0,0,0,0,0,0,0,0,0,0,1,1,0,1,1,2,4,4,2,7
14,14,14,14,14,14,14,14,14,14,14,10,0,0,0,0,0,0,0,0,0,0,0,0,0,0,0,5,5,5,0,0,0,0,0,0,2,2,2,2,1,2,2,1,1,2,2,2,2,2
14,14,14,14,14,14,14,14,14,14,14,10,0,0,0,0,0,0,0,0,0,0,0,0,0,0,0,5,5,5,0,2,2,2,2,2,2,2,2,2,1,2,2,1,1,2,2,2,2,2
14,14,14,14,14,14,14,14,14,14,10,0,0,0,0,0,0,0,2,2,2,2,2,2,2,2,2,5,5,5,5,5,2,2,2,2,2,2,2,2,1,2,2,1,1,2,2,2,2,2
14,14,14,14,14,14,14,14,14,14,10,0,0,0,0,0,0,0,2,2,2,2,2,2,2,2,2,2,5,5,3,3,3,2,2,2,2,2,2,2,2,2,2,2,1,2,2,2,2,2
14,14,14,14,14,14,14,14,14,10,1,0,0,0,0,0,2,2,2,2,2,2,2,2,2,2,2,7,7,5,3,3,3,3,2,2,2,5,5,5,5,5,5,2,2,2,2,2,2,7
14,14,14,14,14,14,14,14,14,10,1,2,2,2,2,2,2,2,2,2,2,2,2,2,2,2,5,7,7,5,3,3,3,2,2,2,2,5,5,5,5,5,5,5,2,2,2,2,7,7
14,14,14,14,14,14,14,14,10,1,1,2,2,2,2,2,2,2,2,2,2,2,2,2,2,2,5,7,7,5,5,5,5,2,2,2,2,5,5,5,5,5,5,5,3,2,2,7,7,7
14,14,14,14,14,14,14,10,2,1,2,2,2,2,2,2,2,2,2,2,2,2,2,2,2,2,5,5,5,5,5,5,5,2,2,2,2,5,5,5,5,5,5,5,3,2,2,7,7,7
14,14,14,14,14,14,10,2,2,1,2,2,2,2,2,2,2,2,2,2,2,2,2,2,2,2,2,5,5,5,5,5,2,2,7,7,7,3,3,3,3,5,5,5,3,2,2,7,7,7
14,14,14,14,14,10,2,2,2,1,2,2,2,2,2,2,2,2,2,2,2,2,2,2,2,2,2,2,2,2,2,2,7,7,7,7,7,3,3,3,3,3,3,3,3,2,3,3,7,7
14,14,14,14,10,2,2,2,2,1,2,2,2,2,2,2,2,2,2,2,2,2,2,2,2,2,2,2,2,2,5,2,7,7,7,7,7,3,3,3,3,3,3,3,2,2,3,3,3,3
14,14,14,10,2,2,2,2,2,2,2,2,2,2,2,2,2,2,2,2,2,2,2,2,2,2,2,5,5,5,5,5,7,7,7,7,7,7,5,3,3,3,3,3,2,2,3,3,3,3
14,14,10,2,2,2,2,2,2,2,2,2,2,2,2,2,2,2,2,2,2,2,2,2,2,2,2,5,5,5,5,5,7,7,7,7,7,7,5,5,5,5,5,5,7,7,3,3,3,3
14,10,2,2,2,2,2,2,2,2,2,2,2,2,2,2,2,2,2,2,2,2,2,2,2,2,2,5,5,5,5,5,5,7,7,7,7,7,5,5,5,5,5,5,7,7,7,6,6,6
10,2,2,2,2,2,2,2,2,2,2,2,2,2,2,2,2,2,2,2,2,2,2,2,2,2,2,5,5,5,5,5,5,2,5,5,5,5,5,5,5,5,7,7,7,7,7,7,7,7
2,2,2,2,2,2,2,2,2,2,2,2,2,2,2,2,2,2,2,2,2,2,2,2,2,2,2,2,2,2,2,2,2,2,2,5,5,5,5,5,5,5,7,7,7,7,7,7,7,7
2,2,2,2,2,2,2,2,2,2,2,2,2,2,2,2,2,2,2,2,2,2,2,2,2,2,2,2,2,2,2,2,2,5,5,5,5,5,7,7,5,5,7,7,7,7,7,7,7,7
2,2,2,2,2,2,2,2,2,2,2,2,2,2,2,2,2,2,2,2,2,2,2,2,2,2,2,2,2,2,2,2,2,5,5,5,5,5,2,2,7,7,7,7,7,7,7,7,7,7
0.7490196,0.8313726,1
0.8078432,0.8745099,1
0.6313726,0.7490196,0.9725491
1,0.8000001,0.9647059
1,0.8627452,0.9176471
1,0.9294118,0.9607844
1,0.9333334,0.9882354
1,0.6980392,0.7764707
1,0.5137255,0.6392157
1,0.4392157,0.5843138
1,0.2784314,0.454902
0.9333334,0.1529412,0.345098
0.9490197,0.4,0.4196079
0.8235295,0.2392157,0.08235294
0.909804,0.3764706,0.5764706